30 100
AGAGAAGTGTGGCTTCGGCTCCCAGCACCT|CTAACGTGCCGAACACTTTGTGCAATAATG
TCTAAAGGGGGATACATCTTAGTGCACTCT|TGCAATAATGCCAAACAAGCTGTCTAAACT
TTTATTGTTGTGCAATAATGCCAAACAAGC|ACAAGCTGTCTATTGTGCAATAATGCCAAA
TGGTAGGGCTGCACTGCAAATTTGCCGTCA|CGATCAATACACCAGCTTGAGCTCGTCTGA
TGCCGTTGTGCAATAATGCCAAACAAGCTG|CACTTTCGACCCGTAGCCTCATCTGTTTTG
ATCACGGGAGATCTTACTTTTGTGCAATAA|TTCGTTTCATGTACTCGGATGCGCTAACCG
AAGCAGCTCAATGGTTTACCAGTATTTTCG|CTAAAACATTACAGAACCAGTGCAGGCGCC
AGCACCCATAACTCGTTTGGGAGTTTATCG|TGAGTATACCGTTGACCTTTGTGCAATAAT
GCAATTTGTGCAATAATGCCAAACAAGCTG|GTTGTGCAATAATGCCAAACAAGCTGTCTA
GTCATCCGCTAGGGAAAACATAGTTGGCCA|GTATAACAGAGTCCCCAGAGAGTTGGTTTG
CGGTAGTTCCGTTGTGCAATAATGCCAAAC|GACGCAGCTGACGACGGCATAATTGATCGC
TAAAATGTGTTGTGCAATAATGCCAAACAA|AGCTGTCTAAGACATGCGGCGATAACGGTA
CACCAGCTTGAGCTCGTCTGAGGTCGTATA|TTTCGTTACTGGTTTATATTAGTGGAGGTT
AATGCCAAACAAGCTGTCTAAAATGCCAAA|CCAAACAAGCTGTCTAAAGGGGGATACATC
TTGTGCAATAATGCCAAACAAGCTGTCTAA|GCAATAATGCCAAACAAGCTGTCTAAAGGG
GGACGGGACTAAGGCATTCGTTTCATGTAC|CGCCGATTAGAATTGTGCAATAATGCCAAA
GCATTCGTTTCATGTACTCGGATGCGCTAA|TGTGCAATAATGCCAAACAAGCTGTCTAAC
TCAATGGTTTACCAGTATTTTCGTTACTGG|ATTACAGAACCAGTGCAGGCGCCAGTTTCG
CATGCGGCGATAACGGTAGTTCCGTTGTGC|ACGACTCTGACCGGACGCAGCTGACGACGG
CTAAAATGTGTTGTGCAATAATGCCAAACA|AAGCTGTCTAAGACATGCGGCGATAACGGT
AATTGATCGCAGCCCGACCATGCTCGTAAT|TAGGGAAAACATAGTTGGCCAGGTAGAGAA
ATGCGCTAACCGGAAGAGAAGTGTGGCTTC|CTGTCTAACATTGTCTAACGTGCCGAACAC
TGTGCAATAATGCCAAACAAGCTGTCTAAA|CAATAATGCCAAACAAGCTGTCTAAAGGGG
AAGCTGTCTAAAACATTACAGAACCAGTGC|CTAAGCGTTCCGGTTAGGAATCACCTTTCG
TACACCAGCTTGAGCTCGTCTGAGGTCGTA|ATTTTCGTTACTGGTTTATATTAGTGGAGG
CTCGTTTGGGAGTTTATCGTTCAGGATAAT|TTGACCTTTGTGCAATAATGCCAAACAAGC
GTGCAATAATGCCAAACAAGCTGTCTAAAG|GACCCGTAGCCTCATCTGTTTTGTGCAATA
AGTTGTGCAATAATGCCAAACAAGCTGTCT|ATTGTAGCTTGTGCAATTTGTGCAATAATG
AATAATGCCAAACAAGCTGTCTAAAGGGGG|CGTAGCCTCATCTGTTTTGTGCAATAATGC
TGCCAAACAAGCTGTCTAAACACGATCAAT|AATGCGAAGCAGCTCAATGGTTTACCAGTA
GCGATTGTAGCTTGTGCAATTTGTGCAATA|CCCTATACAGGTGCCGTTGTGCAATAATGC
CACCTCTCGTCTCGTTAACGCTGCCTGGTA|TAATGCCAAACAAGCTGTCTAAACACGATC
CCATAACTCGTTTGGGAGTTTATCGTTCAG|ATACCGTTGACCTTTGTGCAATAATGCCAA
TTGTAGCTTGTGCAATTTGTGCAATAATGC|ATACAGGTGCCGTTGTGCAATAATGCCAAA
GTTAGGAATCACCTTTCGCATGGACGCTAG|GTCTTGTGCAATAATGCCAAACAAGCTGTC
CTATCACGGGAGATCTTACTTTTGTGCAAT|CATTCGTTTCATGTACTCGGATGCGCTAAC
TAGACGCGGCCCAACTAGCACCCATAACTC|GAAAGGTGCGCCGTTTTGAGTATACCGTTG
CGCAGCCCGACCATGCTCGTAATCTGTCCA|AACATAGTTGGCCAGGTAGAGAACGTTCAC
GTCTCTGGCCTGACCAGTGCACCATGGTGT|TTAACGCTGCCTGGTAGGGCTGCACTGCAA
TATTTTCGTTACTGGTTTATATTAGTGGAG|CAGGCGCCAGTTTCGGAAGCTGCGAACTGT
TCTCGTCTCGTTAACGCTGCCTGGTAGGGC|GCCAAACAAGCTGTCTAAACACGATCAATA
GCTGTCTAAGCGTTCCGGTTAGGAATCACC|ATAATGCCAAACAAGCTGTCTTGTGCAATA
GTTCCGTTGTGCAATAATGCCAAACAAGCT|AGCTGACGACGGCATAATTGATCGCAGCCC
TGCCAAACAAGCTGTCTAACATTGTCTAAC|AGACGCGGCCCAACTAGCACCCATAACTCG
ACTCTCCACGACTCTGACCGGACGCAGCTG|AAACTGCATGTGGCGATAAAGAGCCTTTGC
ATAATGCCAAACAAGCTGTCTAAAGGGGGA|GTAGCCTCATCTGTTTTGTGCAATAATGCC
AAGCGTTCCGGTTAGGAATCACCTTTCGCA|CAAACAAGCTGTCTTGTGCAATAATGCCAA
GCCAAACAAGCTGTCTATTGTGCAATAATG|AATTTGTGCAATAATGCCAAACAAGCTGTC
CGTTTGGGAGTTTATCGTTCAGGATAATGC|GACCTTTGTGCAATAATGCCAAACAAGCTG
CTAAAACATTACAGAACCAGTGCAGGCGCC|TTCCGGTTAGGAATCACCTTTCGCATGGAC
GGAAGTCCGACTGGTAGCGTTCGTCTCTGG|GCTCCCAGCACCTCTCGTCTCGTTAACGCT
AGCCTCATCTGTTTTGTGCAATAATGCCAA|TGGCGTCTACCCGCGCCAGATTGCTCGTTA
TGTCACCGTTTGATAAGGACGGGACTAAGG|CAAATTTGCCGTCAAGCGCCGATTAGAATT
TTTCGTTACTGGTTTATATTAGTGGAGGTT|GCGCCAGTTTCGGAAGCTGCGAACTGTTCG
CAATAATGCCAAACAAGCTGTCTAATAAGC|CAATAATGCCAAACAAGCTGTCTAATAGCC
AATGTGTTGTGCAATAATGCCAAACAAGCT|TGTCTAAGACATGCGGCGATAACGGTAGTT
GAACCAGTGCAGGCGCCAGTTTCGGAAGCT|TCACCTTTCGCATGGACGCTAGATGCATTT
TTAAGTTGTGCAATAATGCCAAACAAGCTG|GCGATTGTAGCTTGTGCAATTTGTGCAATA
ATAAGCGATTGTAGCTTGTGCAATTTGTGC|ATAGCCCTATACAGGTGCCGTTGTGCAATA
GACGGGACTAAGGCATTCGTTTCATGTACT|GCCGATTAGAATTGTGCAATAATGCCAAAC
ACCAGCTATCACGGGAGATCTTACTTTTGT|TAAGGCATTCGTTTCATGTACTCGGATGCG
GTTGTGCAATAATGCCAAACAAGCTGTCTA|TGTCTATTGTGCAATAATGCCAAACAAGCT
AGTGCAGGCGCCAGTTTCGGAAGCTGCGAA|TTTCGCATGGACGCTAGATGCATTTAAGTT
AAGCTGTCTAACATTGTCTAACGTGCCGAA|CCCAACTAGCACCCATAACTCGTTTGGGAG
ACAAGCTGTCTAAAATGCCAAACAAGCTGT|GCTGTCTAAAGGGGGATACATCTTAGTGCA
AATGCCAAACAAGCTGTCTAAAATGTGTTG|TGTCTAAAATGCCAAACAAGCTGTCTAAGA
GCAGGCGCCAGTTTCGGAAGCTGCGAACTG|CGCATGGACGCTAGATGCATTTAAGTTGTG
AGTGCACCATGGTGTCACCGTTTGATAAGG|AGGGCTGCACTGCAAATTTGCCGTCAAGCG
TGGGAGTTTATCGTTCAGGATAATGCGAAG|TTTGTGCAATAATGCCAAACAAGCTGTCTA
CGAACACTTTGTGCAATAATGCCAAACAAG|GGAGTTTATCGTTCAGGATAATGCGAAGCA
GTAGGGCTGCACTGCAAATTTGCCGTCAAG|ATCAATACACCAGCTTGAGCTCGTCTGAGG
CGATTGTAGCTTGTGCAATTTGTGCAATAA|CCTATACAGGTGCCGTTGTGCAATAATGCC
GGGAAAACATAGTTGGCCAGGTAGAGAACG|TCCCCAGAGAGTTGGTTTGTCGCGTAAGGC
TGCAATAATGCCAAACAAGCTGTCTAATGC|TATTGTGCAATAATGCCAAACAAGCTGTCT
GATCGCAGCCCGACCATGCTCGTAATCTGT|GAAAACATAGTTGGCCAGGTAGAGAACGTT
GCTTCGGCTCCCAGCACCTCTCGTCTCGTT|AACACTTTGTGCAATAATGCCAAACAAGCT
AGCTGTCTAAACTGCATGTGGCGATAAAGA|CCACCCAGATGGGTGCGCCTCAAGCGAGAA
GAAACCCTAGACGCGGCCCAACTAGCACCC|AACTGTGGAAAGGTGCGCCGTTTTGAGTAT
TAATTGATCGCAGCCCGACCATGCTCGTAA|CTAGGGAAAACATAGTTGGCCAGGTAGAGA
AGTTGCAACTGTGGAAAGGTGCGCCGTTTT|GCGGGTTTTATTGTTGTGCAATAATGCCAA
GCGTTCCGGTTAGGAATCACCTTTCGCATG|AACAAGCTGTCTTGTGCAATAATGCCAAAC
TTTTGTGCAATAATGCCAAACAAGCTGTCT|GATGCGCTAACCGGAAGAGAAGTGTGGCTT
GTGCAATAATGCCAAACAAGCTGTCTAAAA|AATAATGCCAAACAAGCTGTCTAAAGGGGG
AACGGTAGTTCCGTTGTGCAATAATGCCAA|CGGACGCAGCTGACGACGGCATAATTGATC
AAGCTGTCTAAAGGGGGATACATCTTAGTG|GTTTTGTGCAATAATGCCAAACAAGCTGTC
AACTCGTTTGGGAGTTTATCGTTCAGGATA|CGTTGACCTTTGTGCAATAATGCCAAACAA
TTTTGTGCAATAATGCCAAACAAGCTGTCT|CGCGCCAGATTGCTCGTTAATGCCACCCAG
CAGCTCAATGGTTTACCAGTATTTTCGTTA|AAACATTACAGAACCAGTGCAGGCGCCAGT
GCATGGACGCTAGATGCATTTAAGTTGTGC|CAAACAAGCTGTCTAATAAGCGATTGTAGC
GCCAAACAAGCTGTCTAAGCGTTCCGGTTA|TGTTGTGCAATAATGCCAAACAAGCTGTCT
CCAAACAAGCTGTCTAACATTGTCTAACGT|ACGCGGCCCAACTAGCACCCATAACTCGTT
TCGCGGGTTTTATTGTTGTGCAATAATGCC|AATGCCAAACAAGCTGTCTATTGTGCAATA
CATGCTCGTAATCTGTCCACTTTCGACCCG|CCAGGTAGAGAACGTTCACTGCAGATGGAT
GTGCAATAATGCCAAACAAGCTGTCTAATG|CTATTGTGCAATAATGCCAAACAAGCTGTC
AGGAAGTCCGACTGGTAGCGTTCGTCTCTG|GGCTCCCAGCACCTCTCGTCTCGTTAACGC
TGCAATTTGTGCAATAATGCCAAACAAGCT|CGTTGTGCAATAATGCCAAACAAGCTGTCT
GCCAAACAAGCTGTCTTGTGCAATAATGCC|ATAACGGTAGTTCCGTTGTGCAATAATGCC
CCAGCTATCACGGGAGATCTTACTTTTGTG|AAGGCATTCGTTTCATGTACTCGGATGCGC
AAACATTACAGAACCAGTGCAGGCGCCAGT|CGGTTAGGAATCACCTTTCGCATGGACGCT
GTCTAATAGCCCTATACAGGTGCCGTTGTG|GACCATGCTCGTAATCTGTCCACTTTCGAC
AGCAGCTCAATGGTTTACCAGTATTTTCGT|TAAAACATTACAGAACCAGTGCAGGCGCCA
GTCTAACATTGTCTAACGTGCCGAACACTT|CTAGCACCCATAACTCGTTTGGGAGTTTAT
CGATAACGGTAGTTCCGTTGTGCAATAATG|TGACCGGACGCAGCTGACGACGGCATAATT
TAGCGTTCGTCTCTGGCCTGACCAGTGCAC|TCGTCTCGTTAACGCTGCCTGGTAGGGCTG
TTGTAGTTGCAACTGTGGAAAGGTGCGCCG|CGTCGCGGGTTTTATTGTTGTGCAATAATG
GCAATAATGCCAAACAAGCTGTCTAAAATG|CAAGCTGTCTAAAATGCCAAACAAGCTGTC
TGCGCCGTTTTGAGTATACCGTTGACCTTT|AATAATGCCAAACAAGCTGTCTAATGCAAT
TGTACTCGGATGCGCTAACCGGAAGAGAAG|CCAAACAAGCTGTCTAACATTGTCTAACGT
CTTTGTGCAATAATGCCAAACAAGCTGTCT|CAATAATGCCAAACAAGCTGTCTAAGCGTT
CGGTTAGGAATCACCTTTCGCATGGACGCT|CTGTCTTGTGCAATAATGCCAAACAAGCTG
AATGCCAAACAAGCTGTCTATTGTGCAATA|TGCAATTTGTGCAATAATGCCAAACAAGCT
GCTGTCTAATGCAATAATGCCAAACAAGCT|AACAAGCTGTCTAAAATGTGTTGTGCAATA
TCTAATAAGCGATTGTAGCTTGTGCAATTT|TCTAATAGCCCTATACAGGTGCCGTTGTGC
GGCGATAAAGAGCCTTTGCTGTCATCCGCT|TCAAGCGAGAAGTGGGATTAGTATAACAGA
GGCGATAACGGTAGTTCCGTTGTGCAATAA|TCTGACCGGACGCAGCTGACGACGGCATAA
AACAAGCTGTCTAACATTGTCTAACGTGCC|CGGCCCAACTAGCACCCATAACTCGTTTGG
AGGAATCACCTTTCGCATGGACGCTAGATG|TTGTGCAATAATGCCAAACAAGCTGTCTAA
CGGATGCGCTAACCGGAAGAGAAGTGTGGC|AAGCTGTCTAACATTGTCTAACGTGCCGAA
AACAAGCTGTCTATTGTGCAATAATGCCAA|TGTGCAATAATGCCAAACAAGCTGTCTAAA
GCCGTTTTGAGTATACCGTTGACCTTTGTG|AATGCCAAACAAGCTGTCTAATGCAATAAT
GTCTAAACTGCATGTGGCGATAAAGAGCCT|CCAGATGGGTGCGCCTCAAGCGAGAAGTGG
AACTGTGGAAAGGTGCGCCGTTTTGAGTAT|TTTATTGTTGTGCAATAATGCCAAACAAGC
CCCGTAGCCTCATCTGTTTTGTGCAATAAT|GGATCTGGCGTCTACCCGCGCCAGATTGCT
TTCGTTTCATGTACTCGGATGCGCTAACCG|GCAATAATGCCAAACAAGCTGTCTAACATT
GCCAAACAAGCTGTCTAAACTGCATGTGGC|CGTTAATGCCACCCAGATGGGTGCGCCTCA
CAAGCTGTCTAAGGAAGTCCGACTGGTAGC|AGTGTGGCTTCGGCTCCCAGCACCTCTCGT
TCGGAAGCTGCGAACTGTTCGTCGCGGGTT|GATGCATTTAAGTTGTGCAATAATGCCAAA
CGGAAGAGAAGTGTGGCTTCGGCTCCCAGC|TTGTCTAACGTGCCGAACACTTTGTGCAAT
GGCGCCAGTTTCGGAAGCTGCGAACTGTTC|ATGGACGCTAGATGCATTTAAGTTGTGCAA
GGGAGTTTATCGTTCAGGATAATGCGAAGC|TTGTGCAATAATGCCAAACAAGCTGTCTAA
TCCACTTTCGACCCGTAGCCTCATCTGTTT|TCACTGCAGATGGATCTGGCGTCTACCCGC
TGTCGCGAAACCCTAGACGCGGCCCAACTA|AGTTGCAACTGTGGAAAGGTGCGCCGTTTT
GTAGCTTGTGCAATTTGTGCAATAATGCCA|ACAGGTGCCGTTGTGCAATAATGCCAAACA
AAGCTGTCTATTGTGCAATAATGCCAAACA|GCAATAATGCCAAACAAGCTGTCTAAAATG
TATTGTGCAATAATGCCAAACAAGCTGTCT|GCCAAACAAGCTGTCTAAAATGCCAAACAA
GAAGCTGCGAACTGTTCGTCGCGGGTTTTA|GCATTTAAGTTGTGCAATAATGCCAAACAA
GAATTGTGCAATAATGCCAAACAAGCTGTC|TGTCGCGAAACCCTAGACGCGGCCCAACTA
TCTCCACGACTCTGACCGGACGCAGCTGAC|ACTGCATGTGGCGATAAAGAGCCTTTGCTG
GTCCACTTTCGACCCGTAGCCTCATCTGTT|TTCACTGCAGATGGATCTGGCGTCTACCCG
TCAATACACCAGCTTGAGCTCGTCTGAGGT|CAGTATTTTCGTTACTGGTTTATATTAGTG
CAGCACCTCTCGTCTCGTTAACGCTGCCTG|CAATAATGCCAAACAAGCTGTCTAAACACG
ACTAAGGCATTCGTTTCATGTACTCGGATG|TAGAATTGTGCAATAATGCCAAACAAGCTG
AACTGTTCGTCGCGGGTTTTATTGTTGTGC|TTGTGCAATAATGCCAAACAAGCTGTCTAT
CCGACCATGCTCGTAATCTGTCCACTTTCG|GTTGGCCAGGTAGAGAACGTTCACTGCAGA
TGCCAAACAAGCTGTCTTGTGCAATAATGC|GATAACGGTAGTTCCGTTGTGCAATAATGC
CTAACGTGCCGAACACTTTGTGCAATAATG|ACTCGTTTGGGAGTTTATCGTTCAGGATAA
GGACTAAGGCATTCGTTTCATGTACTCGGA|ATTAGAATTGTGCAATAATGCCAAACAAGC
TTTTATTGTTGTGCAATAATGCCAAACAAG|AACAAGCTGTCTATTGTGCAATAATGCCAA
TGCAATAATGCCAAACAAGCTGTCTAAAAT|ACAAGCTGTCTAAAATGCCAAACAAGCTGT
CTTGTGCAATAATGCCAAACAAGCTGTCTA|GTTGTGCAATAATGCCAAACAAGCTGTCTA
AATGCCAAACAAGCTGTCTAAGGAAGTCCG|CGGAAGAGAAGTGTGGCTTCGGCTCCCAGC
ACATTGTCTAACGTGCCGAACACTTTGTGC|ACCCATAACTCGTTTGGGAGTTTATCGTTC
TTGTGCAATAATGCCAAACAAGCTGTCTTG|AGACATGCGGCGATAACGGTAGTTCCGTTG
AGAACCAGTGCAGGCGCCAGTTTCGGAAGC|ATCACCTTTCGCATGGACGCTAGATGCATT
GCTAGATGCATTTAAGTTGTGCAATAATGC|CTGTCTAATAAGCGATTGTAGCTTGTGCAA
TTGTGCAATAATGCCAAACAAGCTGTCTAA|CGACGGCATAATTGATCGCAGCCCGACCAT
TAGCACCCATAACTCGTTTGGGAGTTTATC|TTGAGTATACCGTTGACCTTTGTGCAATAA
CCGGAAGAGAAGTGTGGCTTCGGCTCCCAG|ATTGTCTAACGTGCCGAACACTTTGTGCAA
GTCTTGTGCAATAATGCCAAACAAGCTGTC|CCGTTGTGCAATAATGCCAAACAAGCTGTC
ATGCCAAACAAGCTGTCTAATAGCCCTATA|ATTGATCGCAGCCCGACCATGCTCGTAATC
ACGGGACTAAGGCATTCGTTTCATGTACTC|CCGATTAGAATTGTGCAATAATGCCAAACA
AGTTCCGTTGTGCAATAATGCCAAACAAGC|CAGCTGACGACGGCATAATTGATCGCAGCC
CGTTCCGGTTAGGAATCACCTTTCGCATGG|ACAAGCTGTCTTGTGCAATAATGCCAAACA
TCCGCTAGGGAAAACATAGTTGGCCAGGTA|AACAGAGTCCCCAGAGAGTTGGTTTGTCGC
TGCCAAACAAGCTGTCTAAGCGTTCCGGTT|GTGTTGTGCAATAATGCCAAACAAGCTGTC
CAAACAAGCTGTCTAATGCAATAATGCCAA|AATGCCAAACAAGCTGTCTAAAATGTGTTG
TAGCCCTATACAGGTGCCGTTGTGCAATAA|GCTCGTAATCTGTCCACTTTCGACCCGTAG
TCTGACCGGACGCAGCTGACGACGGCATAA|GCGATAAAGAGCCTTTGCTGTCATCCGCTA
AACACGATCAATACACCAGCTTGAGCTCGT|GGTTTACCAGTATTTTCGTTACTGGTTTAT
CTAAACACGATCAATACACCAGCTTGAGCT|AATGGTTTACCAGTATTTTCGTTACTGGTT
ATAATGCCAAACAAGCTGTCTAATGCAATA|GTGCAATAATGCCAAACAAGCTGTCTAAAA
CAAGCTGTCTAAACTGCATGTGGCGATAAA|TGCCACCCAGATGGGTGCGCCTCAAGCGAG
ATAATGCCAAACAAGCTGTCTATTGTGCAA|TGTGCAATTTGTGCAATAATGCCAAACAAG
TAATGCCAAACAAGCTGTCTAATAGCCCTA|TAATTGATCGCAGCCCGACCATGCTCGTAA
AAACAAGCTGTCTAATGCAATAATGCCAAA|ATGCCAAACAAGCTGTCTAAAATGTGTTGT
CGTCTCGTTAACGCTGCCTGGTAGGGCTGC|AAACAAGCTGTCTAAACACGATCAATACAC
CTGCATGTGGCGATAAAGAGCCTTTGCTGT|GGTGCGCCTCAAGCGAGAAGTGGGATTAGT
ACGCGGCCCAACTAGCACCCATAACTCGTT|AGGTGCGCCGTTTTGAGTATACCGTTGACC
ATGCTCGTAATCTGTCCACTTTCGACCCGT|CAGGTAGAGAACGTTCACTGCAGATGGATC
AATCTGTCCACTTTCGACCCGTAGCCTCAT|GAACGTTCACTGCAGATGGATCTGGCGTCT
CTCTGACCGGACGCAGCTGACGACGGCATA|GGCGATAAAGAGCCTTTGCTGTCATCCGCT
GTTGTAGTTGCAACTGTGGAAAGGTGCGCC|TCGTCGCGGGTTTTATTGTTGTGCAATAAT
CAGCTATCACGGGAGATCTTACTTTTGTGC|AGGCATTCGTTTCATGTACTCGGATGCGCT
GGAAGAGAAGTGTGGCTTCGGCTCCCAGCA|TGTCTAACGTGCCGAACACTTTGTGCAATA
GTTCCGGTTAGGAATCACCTTTCGCATGGA|CAAGCTGTCTTGTGCAATAATGCCAAACAA
AGCTGTCTAAAATGTGTTGTGCAATAATGC|CCAAACAAGCTGTCTAAGACATGCGGCGAT
TGTCTAAGACATGCGGCGATAACGGTAGTT|GCACTCTCCACGACTCTGACCGGACGCAGC
TGTCCACTTTCGACCCGTAGCCTCATCTGT|GTTCACTGCAGATGGATCTGGCGTCTACCC
GACTAAGGCATTCGTTTCATGTACTCGGAT|TTAGAATTGTGCAATAATGCCAAACAAGCT
CTAGGGAAAACATAGTTGGCCAGGTAGAGA|GAGTCCCCAGAGAGTTGGTTTGTCGCGTAA
CGTATAGCTGTCGCGAAACCCTAGACGCGG|GAGGTTGTAGTTGCAACTGTGGAAAGGTGC
CGATTAGAATTGTGCAATAATGCCAAACAA|TATAGCTGTCGCGAAACCCTAGACGCGGCC
ACTGCATGTGGCGATAAAGAGCCTTTGCTG|GGGTGCGCCTCAAGCGAGAAGTGGGATTAG
CCCTAGACGCGGCCCAACTAGCACCCATAA|GTGGAAAGGTGCGCCGTTTTGAGTATACCG
GCCGAACACTTTGTGCAATAATGCCAAACA|TGGGAGTTTATCGTTCAGGATAATGCGAAG
AATGCAATAATGCCAAACAAGCTGTCTAAG|TGTCTAAAATGTGTTGTGCAATAATGCCAA
AAGCTGTCTAAGCGTTCCGGTTAGGAATCA|CAATAATGCCAAACAAGCTGTCTTGTGCAA
GCGCTAACCGGAAGAGAAGTGTGGCTTCGG|GTCTAACATTGTCTAACGTGCCGAACACTT
TCTTGTGCAATAATGCCAAACAAGCTGTCT|CGTTGTGCAATAATGCCAAACAAGCTGTCT
GTGGCGATAAAGAGCCTTTGCTGTCATCCG|CCTCAAGCGAGAAGTGGGATTAGTATAACA
GAAGTGTGGCTTCGGCTCCCAGCACCTCTC|ACGTGCCGAACACTTTGTGCAATAATGCCA
CTGTCTAAGGAAGTCCGACTGGTAGCGTTC|TGGCTTCGGCTCCCAGCACCTCTCGTCTCG
TAATGCCAAACAAGCTGTCTATTGTGCAAT|GTGCAATTTGTGCAATAATGCCAAACAAGC
TTATTGTTGTGCAATAATGCCAAACAAGCT|CAAGCTGTCTATTGTGCAATAATGCCAAAC
CCAGGTGCCCTCCACCAGCTATCACGGGAG|ATAAGGACGGGACTAAGGCATTCGTTTCAT
GTCTGCCAGGTGCCCTCCACCAGCTATCAC|GTTTGATAAGGACGGGACTAAGGCATTCGT
TGACCGGACGCAGCTGACGACGGCATAATT|GATAAAGAGCCTTTGCTGTCATCCGCTAGG
CTAGCACCCATAACTCGTTTGGGAGTTTAT|TTTGAGTATACCGTTGACCTTTGTGCAATA
TGCCAAACAAGCTGTCTAAAACATTACAGA|CAAGCTGTCTAAGCGTTCCGGTTAGGAATC
TTGTGCAATAATGCCAAACAAGCTGTCTAA|ATAATGCCAAACAAGCTGTCTAAGCGTTCC
GCTGTCTAAGACATGCGGCGATAACGGTAG|GTGCACTCTCCACGACTCTGACCGGACGCA
AACACTTTGTGCAATAATGCCAAACAAGCT|AGTTTATCGTTCAGGATAATGCGAAGCAGC
GGTAGTTCCGTTGTGCAATAATGCCAAACA|ACGCAGCTGACGACGGCATAATTGATCGCA
TGAGTATACCGTTGACCTTTGTGCAATAAT|AACAAGCTGTCTAATGCAATAATGCCAAAC
AAGAGAAGTGTGGCTTCGGCTCCCAGCACC|TCTAACGTGCCGAACACTTTGTGCAATAAT
TTTGTGCAATAATGCCAAACAAGCTGTCTA|AATAATGCCAAACAAGCTGTCTAAGCGTTC
TCGTCTCGTTAACGCTGCCTGGTAGGGCTG|CAAACAAGCTGTCTAAACACGATCAATACA
GCTGTCTAAAACATTACAGAACCAGTGCAG|AAGCGTTCCGGTTAGGAATCACCTTTCGCA
ACAAGCTGTCTAAACACGATCAATACACCA|AAGCAGCTCAATGGTTTACCAGTATTTTCG
AACCGGAAGAGAAGTGTGGCTTCGGCTCCC|ACATTGTCTAACGTGCCGAACACTTTGTGC
TGTGCAATAATGCCAAACAAGCTGTCTAAA|CGTTCAGGATAATGCGAAGCAGCTCAATGG
GCTGCACTGCAAATTTGCCGTCAAGCGCCG|TACACCAGCTTGAGCTCGTCTGAGGTCGTA
ATAGCTGTCGCGAAACCCTAGACGCGGCCC|GTTGTAGTTGCAACTGTGGAAAGGTGCGCC
GCGGGTTTTATTGTTGTGCAATAATGCCAA|TGCCAAACAAGCTGTCTATTGTGCAATAAT
AACCCTAGACGCGGCCCAACTAGCACCCAT|CTGTGGAAAGGTGCGCCGTTTTGAGTATAC
ACCGTTGACCTTTGTGCAATAATGCCAAAC|TGTCTAATGCAATAATGCCAAACAAGCTGT
GACATGCGGCGATAACGGTAGTTCCGTTGT|CCACGACTCTGACCGGACGCAGCTGACGAC
TTACCAGTATTTTCGTTACTGGTTTATATT|ACCAGTGCAGGCGCCAGTTTCGGAAGCTGC
GCTAACCGGAAGAGAAGTGTGGCTTCGGCT|CTAACATTGTCTAACGTGCCGAACACTTTG
CTAACATTGTCTAACGTGCCGAACACTTTG|AGCACCCATAACTCGTTTGGGAGTTTATCG
GCCTTTGCTGTCATCCGCTAGGGAAAACAT|GTGGGATTAGTATAACAGAGTCCCCAGAGA
CTCTGGCCTGACCAGTGCACCATGGTGTCA|AACGCTGCCTGGTAGGGCTGCACTGCAAAT
GCCCGACCATGCTCGTAATCTGTCCACTTT|TAGTTGGCCAGGTAGAGAACGTTCACTGCA
TATAGCTGTCGCGAAACCCTAGACGCGGCC|GGTTGTAGTTGCAACTGTGGAAAGGTGCGC
AGCACCTCTCGTCTCGTTAACGCTGCCTGG|AATAATGCCAAACAAGCTGTCTAAACACGA
AGCTGTCTAACATTGTCTAACGTGCCGAAC|CCAACTAGCACCCATAACTCGTTTGGGAGT
GACCGGACGCAGCTGACGACGGCATAATTG|ATAAAGAGCCTTTGCTGTCATCCGCTAGGG
GTCAAGCGCCGATTAGAATTGTGCAATAAT|CTGAGGTCGTATAGCTGTCGCGAAACCCTA
TGTTGTGCAATAATGCCAAACAAGCTGTCT|TAAGACATGCGGCGATAACGGTAGTTCCGT
AATCACCTTTCGCATGGACGCTAGATGCAT|TGCAATAATGCCAAACAAGCTGTCTAATAA
GCCCAACTAGCACCCATAACTCGTTTGGGA|CGCCGTTTTGAGTATACCGTTGACCTTTGT
GCTTGAGCTCGTCTGAGGTCGTATAGCTGT|TTACTGGTTTATATTAGTGGAGGTTGTAGT
CACCGTTTGATAAGGACGGGACTAAGGCAT|ATTTGCCGTCAAGCGCCGATTAGAATTGTG
TTGTGCAATAATGCCAAACAAGCTGTCTAA|TCGACCCGTAGCCTCATCTGTTTTGTGCAA
CCTGACCAGTGCACCATGGTGTCACCGTTT|GCCTGGTAGGGCTGCACTGCAAATTTGCCG
TGCAAATTTGCCGTCAAGCGCCGATTAGAA|GCTTGAGCTCGTCTGAGGTCGTATAGCTGT
AACAAGCTGTCTAAAATGCCAAACAAGCTG|AGCTGTCTAAAGGGGGATACATCTTAGTGC
TGCAATAATGCCAAACAAGCTGTCTAATAA|TGCAATAATGCCAAACAAGCTGTCTAATAG
ATTTTCGTTACTGGTTTATATTAGTGGAGG|AGGCGCCAGTTTCGGAAGCTGCGAACTGTT
CTGCAAATTTGCCGTCAAGCGCCGATTAGA|AGCTTGAGCTCGTCTGAGGTCGTATAGCTG
ATGCCAAACAAGCTGTCTAAACACGATCAA|TAATGCGAAGCAGCTCAATGGTTTACCAGT
ATCTTAGTGCACTCTCCACGACTCTGACCG|CAAGCTGTCTAAACTGCATGTGGCGATAAA
AGGGCTGCACTGCAAATTTGCCGTCAAGCG|CAATACACCAGCTTGAGCTCGTCTGAGGTC
CTTTCGACCCGTAGCCTCATCTGTTTTGTG|TGCAGATGGATCTGGCGTCTACCCGCGCCA
GATAAAGAGCCTTTGCTGTCATCCGCTAGG|AGCGAGAAGTGGGATTAGTATAACAGAGTC
AATAATGCCAAACAAGCTGTCTAAACTGCA|ATTGCTCGTTAATGCCACCCAGATGGGTGC
CTTAGTGCACTCTCCACGACTCTGACCGGA|AGCTGTCTAAACTGCATGTGGCGATAAAGA
TGTCTAATAGCCCTATACAGGTGCCGTTGT|CGACCATGCTCGTAATCTGTCCACTTTCGA
GTGCCGTTGTGCAATAATGCCAAACAAGCT|CCACTTTCGACCCGTAGCCTCATCTGTTTT
GTGTTGTGCAATAATGCCAAACAAGCTGTC|CTAAGACATGCGGCGATAACGGTAGTTCCG
CGGCCCAACTAGCACCCATAACTCGTTTGG|TGCGCCGTTTTGAGTATACCGTTGACCTTT
TCTAAGACATGCGGCGATAACGGTAGTTCC|ACTCTCCACGACTCTGACCGGACGCAGCTG
AAACAAGCTGTCTATTGTGCAATAATGCCA|TTGTGCAATAATGCCAAACAAGCTGTCTAA
CGGCATAATTGATCGCAGCCCGACCATGCT|ATCCGCTAGGGAAAACATAGTTGGCCAGGT
AGCTGTCTAAGCGTTCCGGTTAGGAATCAC|AATAATGCCAAACAAGCTGTCTTGTGCAAT
TAACGCTGCCTGGTAGGGCTGCACTGCAAA|TGTCTAAACACGATCAATACACCAGCTTGA
GCCGATTAGAATTGTGCAATAATGCCAAAC|CGTATAGCTGTCGCGAAACCCTAGACGCGG
TTTGGGAGTTTATCGTTCAGGATAATGCGA|CCTTTGTGCAATAATGCCAAACAAGCTGTC
GACGCAGCTGACGACGGCATAATTGATCGC|GAGCCTTTGCTGTCATCCGCTAGGGAAAAC
ACTGGTAGCGTTCGTCTCTGGCCTGACCAG|ACCTCTCGTCTCGTTAACGCTGCCTGGTAG
TAGTTGGCCAGGTAGAGAACGTTCACTGCA|AGTTGGTTTGTCGCGTAAGGCCAACTCATA
CGACTGGTAGCGTTCGTCTCTGGCCTGACC|GCACCTCTCGTCTCGTTAACGCTGCCTGGT
TGTCTAATGCAATAATGCCAAACAAGCTGT|CAAGCTGTCTAAAATGTGTTGTGCAATAAT
GGAAAACATAGTTGGCCAGGTAGAGAACGT|CCCCAGAGAGTTGGTTTGTCGCGTAAGGCC
CTCATCTGTTTTGTGCAATAATGCCAAACA|CGTCTACCCGCGCCAGATTGCTCGTTAATG
GGAAAGGTGCGCCGTTTTGAGTATACCGTT|GTTGTGCAATAATGCCAAACAAGCTGTCTA
TAATGCCAAACAAGCTGTCTAATAAGCGAT|TAATGCCAAACAAGCTGTCTAATAGCCCTA
GTAGCGTTCGTCTCTGGCCTGACCAGTGCA|CTCGTCTCGTTAACGCTGCCTGGTAGGGCT
AGTGGAGGTTGTAGTTGCAACTGTGGAAAG|GAACTGTTCGTCGCGGGTTTTATTGTTGTG
ATCTGTTTTGTGCAATAATGCCAAACAAGC|CTACCCGCGCCAGATTGCTCGTTAATGCCA
GCACCATGGTGTCACCGTTTGATAAGGACG|GCTGCACTGCAAATTTGCCGTCAAGCGCCG
CGCGGGTTTTATTGTTGTGCAATAATGCCA|ATGCCAAACAAGCTGTCTATTGTGCAATAA
CCCAACTAGCACCCATAACTCGTTTGGGAG|GCCGTTTTGAGTATACCGTTGACCTTTGTG
AAACAAGCTGTCTAAGCGTTCCGGTTAGGA|TGTGCAATAATGCCAAACAAGCTGTCTTGT
TAATGCCAAACAAGCTGTCTAAGCGTTCCG|AATGTGTTGTGCAATAATGCCAAACAAGCT
TGCAATAATGCCAAACAAGCTGTCTAAAAC|ATGCCAAACAAGCTGTCTAAGCGTTCCGGT
GAAGCAGCTCAATGGTTTACCAGTATTTTC|TCTAAAACATTACAGAACCAGTGCAGGCGC
AACAAGCTGTCTAAACTGCATGTGGCGATA|AATGCCACCCAGATGGGTGCGCCTCAAGCG
CGGAAGCTGCGAACTGTTCGTCGCGGGTTT|ATGCATTTAAGTTGTGCAATAATGCCAAAC
AGTTGGCCAGGTAGAGAACGTTCACTGCAG|GTTGGTTTGTCGCGTAAGGCCAACTCATAT
TTGTTGTGCAATAATGCCAAACAAGCTGTC|GCTGTCTATTGTGCAATAATGCCAAACAAG
CCAAACAAGCTGTCTAATGCAATAATGCCA|TAATGCCAAACAAGCTGTCTAAAATGTGTT
AGTGCACTCTCCACGACTCTGACCGGACGC|TGTCTAAACTGCATGTGGCGATAAAGAGCC
CAATAATGCCAAACAAGCTGTCTAACATTG|AACCCTAGACGCGGCCCAACTAGCACCCAT
ATAATGCCAAACAAGCTGTCTAAGCGTTCC|AAATGTGTTGTGCAATAATGCCAAACAAGC
TAGGGCTGCACTGCAAATTTGCCGTCAAGC|TCAATACACCAGCTTGAGCTCGTCTGAGGT
GTTTTGTGCAATAATGCCAAACAAGCTGTC|CCGCGCCAGATTGCTCGTTAATGCCACCCA
GAGTTTATCGTTCAGGATAATGCGAAGCAG|GTGCAATAATGCCAAACAAGCTGTCTAAAA
GCGAAACCCTAGACGCGGCCCAACTAGCAC|GCAACTGTGGAAAGGTGCGCCGTTTTGAGT
AGCTGTCTATTGTGCAATAATGCCAAACAA|CAATAATGCCAAACAAGCTGTCTAAAATGC
CAAACAAGCTGTCTAATAGCCCTATACAGG|ATCGCAGCCCGACCATGCTCGTAATCTGTC
TCTGAGGTCGTATAGCTGTCGCGAAACCCT|TATTAGTGGAGGTTGTAGTTGCAACTGTGG
AGCTTGAGCTCGTCTGAGGTCGTATAGCTG|GTTACTGGTTTATATTAGTGGAGGTTGTAG
AGCTGTCTAAAACATTACAGAACCAGTGCA|TAAGCGTTCCGGTTAGGAATCACCTTTCGC
TGTCTAAGCGTTCCGGTTAGGAATCACCTT|AATGCCAAACAAGCTGTCTTGTGCAATAAT
GTCGCGAAACCCTAGACGCGGCCCAACTAG|GTTGCAACTGTGGAAAGGTGCGCCGTTTTG
TTCATGTACTCGGATGCGCTAACCGGAAGA|AATGCCAAACAAGCTGTCTAACATTGTCTA
CTGTCTAAAATGCCAAACAAGCTGTCTAAG|CTAAAGGGGGATACATCTTAGTGCACTCTC
TTCGTTACTGGTTTATATTAGTGGAGGTTG|CGCCAGTTTCGGAAGCTGCGAACTGTTCGT
GGTAGCGTTCGTCTCTGGCCTGACCAGTGC|TCTCGTCTCGTTAACGCTGCCTGGTAGGGC
AAACACGATCAATACACCAGCTTGAGCTCG|TGGTTTACCAGTATTTTCGTTACTGGTTTA
GTTTACCAGTATTTTCGTTACTGGTTTATA|GAACCAGTGCAGGCGCCAGTTTCGGAAGCT
AAAATGCCAAACAAGCTGTCTAAGACATGC|GGGGATACATCTTAGTGCACTCTCCACGAC
GCTGACGACGGCATAATTGATCGCAGCCCG|TTGCTGTCATCCGCTAGGGAAAACATAGTT
ATAATGCCAAACAAGCTGTCTAAAATGCCA|TGCCAAACAAGCTGTCTAAAGGGGGATACA
GTGCACCATGGTGTCACCGTTTGATAAGGA|GGGCTGCACTGCAAATTTGCCGTCAAGCGC
CCTAGACGCGGCCCAACTAGCACCCATAAC|TGGAAAGGTGCGCCGTTTTGAGTATACCGT
GCTGTCTAAACTGCATGTGGCGATAAAGAG|CACCCAGATGGGTGCGCCTCAAGCGAGAAG
CTGCCAGGTGCCCTCCACCAGCTATCACGG|TTGATAAGGACGGGACTAAGGCATTCGTTT
AAGCTGTCTAAACTGCATGTGGCGATAAAG|GCCACCCAGATGGGTGCGCCTCAAGCGAGA
CATGTACTCGGATGCGCTAACCGGAAGAGA|TGCCAAACAAGCTGTCTAACATTGTCTAAC
GGATACATCTTAGTGCACTCTCCACGACTC|GCCAAACAAGCTGTCTAAACTGCATGTGGC
TGTGCAATAATGCCAAACAAGCTGTCTAAA|TAATGCCAAACAAGCTGTCTAAGCGTTCCG
TGTCTAACATTGTCTAACGTGCCGAACACT|ACTAGCACCCATAACTCGTTTGGGAGTTTA
TTCGTCTCTGGCCTGACCAGTGCACCATGG|TCGTTAACGCTGCCTGGTAGGGCTGCACTG
GGAGGTTGTAGTTGCAACTGTGGAAAGGTG|CTGTTCGTCGCGGGTTTTATTGTTGTGCAA
GGGTTTTATTGTTGTGCAATAATGCCAAAC|CCAAACAAGCTGTCTATTGTGCAATAATGC
GTCTAATAAGCGATTGTAGCTTGTGCAATT|GTCTAATAGCCCTATACAGGTGCCGTTGTG
GGCCCAACTAGCACCCATAACTCGTTTGGG|GCGCCGTTTTGAGTATACCGTTGACCTTTG
CAAGCTGTCTAAACACGATCAATACACCAG|AGCAGCTCAATGGTTTACCAGTATTTTCGT
TTTACCAGTATTTTCGTTACTGGTTTATAT|AACCAGTGCAGGCGCCAGTTTCGGAAGCTG
AGCTATCACGGGAGATCTTACTTTTGTGCA|GGCATTCGTTTCATGTACTCGGATGCGCTA
AGCCTTTGCTGTCATCCGCTAGGGAAAACA|AGTGGGATTAGTATAACAGAGTCCCCAGAG
CGTTTTGAGTATACCGTTGACCTTTGTGCA|TGCCAAACAAGCTGTCTAATGCAATAATGC
ACAAGCTGTCTAAGCGTTCCGGTTAGGAAT|TGCAATAATGCCAAACAAGCTGTCTTGTGC
AGCTGTCTAATGCAATAATGCCAAACAAGC|AAACAAGCTGTCTAAAATGTGTTGTGCAAT
AGCGTTCGTCTCTGGCCTGACCAGTGCACC|CGTCTCGTTAACGCTGCCTGGTAGGGCTGC
TGCCTGGTAGGGCTGCACTGCAAATTTGCC|AACACGATCAATACACCAGCTTGAGCTCGT
TAGCTGTCGCGAAACCCTAGACGCGGCCCA|TTGTAGTTGCAACTGTGGAAAGGTGCGCCG
TTTATCGTTCAGGATAATGCGAAGCAGCTC|CAATAATGCCAAACAAGCTGTCTAAAACAT
TAAGGACGGGACTAAGGCATTCGTTTCATG|AAGCGCCGATTAGAATTGTGCAATAATGCC
ACCGGACGCAGCTGACGACGGCATAATTGA|TAAAGAGCCTTTGCTGTCATCCGCTAGGGA
GGTGCCCTCCACCAGCTATCACGGGAGATC|AGGACGGGACTAAGGCATTCGTTTCATGTA
GATAAGGACGGGACTAAGGCATTCGTTTCA|TCAAGCGCCGATTAGAATTGTGCAATAATG
GCCTGGTAGGGCTGCACTGCAAATTTGCCG|ACACGATCAATACACCAGCTTGAGCTCGTC
GAAAACATAGTTGGCCAGGTAGAGAACGTT|CCCAGAGAGTTGGTTTGTCGCGTAAGGCCA
AGGATAATGCGAAGCAGCTCAATGGTTTAC|AAACAAGCTGTCTAAAACATTACAGAACCA
CTGTCTAATAAGCGATTGTAGCTTGTGCAA|CTGTCTAATAGCCCTATACAGGTGCCGTTG
TATCGTTCAGGATAATGCGAAGCAGCTCAA|ATAATGCCAAACAAGCTGTCTAAAACATTA
CTTCGGCTCCCAGCACCTCTCGTCTCGTTA|ACACTTTGTGCAATAATGCCAAACAAGCTG
TCTAAGCGTTCCGGTTAGGAATCACCTTTC|TGCCAAACAAGCTGTCTTGTGCAATAATGC
AATGCCAAACAAGCTGTCTAAGCGTTCCGG|ATGTGTTGTGCAATAATGCCAAACAAGCTG
CATAACTCGTTTGGGAGTTTATCGTTCAGG|TACCGTTGACCTTTGTGCAATAATGCCAAA
AGAGCCTTTGCTGTCATCCGCTAGGGAAAA|GAAGTGGGATTAGTATAACAGAGTCCCCAG
TTTCGACCCGTAGCCTCATCTGTTTTGTGC|GCAGATGGATCTGGCGTCTACCCGCGCCAG
GCTGTCTAAAGGGGGATACATCTTAGTGCA|TTTGTGCAATAATGCCAAACAAGCTGTCTA
AAGCTGTCTAAGGAAGTCCGACTGGTAGCG|GTGTGGCTTCGGCTCCCAGCACCTCTCGTC
ACATGCGGCGATAACGGTAGTTCCGTTGTG|CACGACTCTGACCGGACGCAGCTGACGACG
CCTGGTAGGGCTGCACTGCAAATTTGCCGT|CACGATCAATACACCAGCTTGAGCTCGTCT
ACCTTTCGCATGGACGCTAGATGCATTTAA|ATAATGCCAAACAAGCTGTCTAATAAGCGA
CGTCTCTGGCCTGACCAGTGCACCATGGTG|GTTAACGCTGCCTGGTAGGGCTGCACTGCA
CACTTTCGACCCGTAGCCTCATCTGTTTTG|ACTGCAGATGGATCTGGCGTCTACCCGCGC
TCGTCTGAGGTCGTATAGCTGTCGCGAAAC|TTATATTAGTGGAGGTTGTAGTTGCAACTG
ACGGCATAATTGATCGCAGCCCGACCATGC|CATCCGCTAGGGAAAACATAGTTGGCCAGG
GCAATAATGCCAAACAAGCTGTCTAAACAC|TCAGGATAATGCGAAGCAGCTCAATGGTTT
TTCGACCCGTAGCCTCATCTGTTTTGTGCA|CAGATGGATCTGGCGTCTACCCGCGCCAGA
CTGCGAACTGTTCGTCGCGGGTTTTATTGT|TTAAGTTGTGCAATAATGCCAAACAAGCTG
GCTCGTAATCTGTCCACTTTCGACCCGTAG|GGTAGAGAACGTTCACTGCAGATGGATCTG
AAGGCATTCGTTTCATGTACTCGGATGCGC|AATTGTGCAATAATGCCAAACAAGCTGTCT
AACGCTGCCTGGTAGGGCTGCACTGCAAAT|GTCTAAACACGATCAATACACCAGCTTGAG
GCCAAACAAGCTGTCTAAAGGGGGATACAT|CTCATCTGTTTTGTGCAATAATGCCAAACA
GTACTCGGATGCGCTAACCGGAAGAGAAGT|CAAACAAGCTGTCTAACATTGTCTAACGTG
AATGCCAAACAAGCTGTCTAAAACATTACA|AACAAGCTGTCTAAGCGTTCCGGTTAGGAA
CCAGTGCAGGCGCCAGTTTCGGAAGCTGCG|CCTTTCGCATGGACGCTAGATGCATTTAAG
TATCACGGGAGATCTTACTTTTGTGCAATA|ATTCGTTTCATGTACTCGGATGCGCTAACC
AAACCCTAGACGCGGCCCAACTAGCACCCA|ACTGTGGAAAGGTGCGCCGTTTTGAGTATA
CTGGCCTGACCAGTGCACCATGGTGTCACC|CGCTGCCTGGTAGGGCTGCACTGCAAATTT
GCCGTCAAGCGCCGATTAGAATTGTGCAAT|CGTCTGAGGTCGTATAGCTGTCGCGAAACC
TTGTGCAATAATGCCAAACAAGCTGTCTAA|TGCGCTAACCGGAAGAGAAGTGTGGCTTCG
TTATCGTTCAGGATAATGCGAAGCAGCTCA|AATAATGCCAAACAAGCTGTCTAAAACATT
TGTCTATTGTGCAATAATGCCAAACAAGCT|TAATGCCAAACAAGCTGTCTAAAATGCCAA
AAACAAGCTGTCTAAACTGCATGTGGCGAT|TAATGCCACCCAGATGGGTGCGCCTCAAGC
TAGATGCATTTAAGTTGTGCAATAATGCCA|GTCTAATAAGCGATTGTAGCTTGTGCAATT
CATGTGGCGATAAAGAGCCTTTGCTGTCAT|GCGCCTCAAGCGAGAAGTGGGATTAGTATA
AGTTTATCGTTCAGGATAATGCGAAGCAGC|TGCAATAATGCCAAACAAGCTGTCTAAAAC
TAATGCCAAACAAGCTGTCTAAAATGTGTT|CTGTCTAAAATGCCAAACAAGCTGTCTAAG
CAAGCTGTCTAAAACATTACAGAACCAGTG|TCTAAGCGTTCCGGTTAGGAATCACCTTTC
GACGCTAGATGCATTTAAGTTGTGCAATAA|AAGCTGTCTAATAAGCGATTGTAGCTTGTG
ATACATCTTAGTGCACTCTCCACGACTCTG|CAAACAAGCTGTCTAAACTGCATGTGGCGA
AAGCGCCGATTAGAATTGTGCAATAATGCC|AGGTCGTATAGCTGTCGCGAAACCCTAGAC
CGCAGCTGACGACGGCATAATTGATCGCAG|GCCTTTGCTGTCATCCGCTAGGGAAAACAT
TAAGACATGCGGCGATAACGGTAGTTCCGT|TCTCCACGACTCTGACCGGACGCAGCTGAC
AGGTGCCCTCCACCAGCTATCACGGGAGAT|AAGGACGGGACTAAGGCATTCGTTTCATGT
AAGGAAGTCCGACTGGTAGCGTTCGTCTCT|CGGCTCCCAGCACCTCTCGTCTCGTTAACG
CGTTCGTCTCTGGCCTGACCAGTGCACCAT|TCTCGTTAACGCTGCCTGGTAGGGCTGCAC
TGTGCAATAATGCCAAACAAGCTGTCTATT|GTAGCTTGTGCAATTTGTGCAATAATGCCA
TAATGCAATAATGCCAAACAAGCTGTCTAA|CTGTCTAAAATGTGTTGTGCAATAATGCCA
TGCAATAATGCCAAACAAGCTGTCTAAAAT|ATAATGCCAAACAAGCTGTCTAAAGGGGGA
TGGTGTCACCGTTTGATAAGGACGGGACTA|CTGCAAATTTGCCGTCAAGCGCCGATTAGA
TCTGTTTTGTGCAATAATGCCAAACAAGCT|TACCCGCGCCAGATTGCTCGTTAATGCCAC
CCCATAACTCGTTTGGGAGTTTATCGTTCA|TATACCGTTGACCTTTGTGCAATAATGCCA
GGTTGTAGTTGCAACTGTGGAAAGGTGCGC|TTCGTCGCGGGTTTTATTGTTGTGCAATAA
CAGTATTTTCGTTACTGGTTTATATTAGTG|GTGCAGGCGCCAGTTTCGGAAGCTGCGAAC
GGCTCCCAGCACCTCTCGTCTCGTTAACGC|TTTGTGCAATAATGCCAAACAAGCTGTCTA
ATTGTTGTGCAATAATGCCAAACAAGCTGT|AGCTGTCTATTGTGCAATAATGCCAAACAA
TAAGCGTTCCGGTTAGGAATCACCTTTCGC|CCAAACAAGCTGTCTTGTGCAATAATGCCA
ACCTTTGTGCAATAATGCCAAACAAGCTGT|TGCAATAATGCCAAACAAGCTGTCTAAGCG
GCCAAACAAGCTGTCTAATGCAATAATGCC|ATAATGCCAAACAAGCTGTCTAAAATGTGT
CAATAATGCCAAACAAGCTGTCTAAAGGGG|CCGTAGCCTCATCTGTTTTGTGCAATAATG
TGCAATAATGCCAAACAAGCTGTCTAAACA|TTCAGGATAATGCGAAGCAGCTCAATGGTT
TGCCAAACAAGCTGTCTATTGTGCAATAAT|CAATTTGTGCAATAATGCCAAACAAGCTGT
TGGTTTACCAGTATTTTCGTTACTGGTTTA|CAGAACCAGTGCAGGCGCCAGTTTCGGAAG
TTCGCATGGACGCTAGATGCATTTAAGTTG|TGCCAAACAAGCTGTCTAATAAGCGATTGT
CCAAACAAGCTGTCTAAGACATGCGGCGAT|ACATCTTAGTGCACTCTCCACGACTCTGAC
GTTTTGAGTATACCGTTGACCTTTGTGCAA|GCCAAACAAGCTGTCTAATGCAATAATGCC
GCTGTCTAATAAGCGATTGTAGCTTGTGCA|GCTGTCTAATAGCCCTATACAGGTGCCGTT
ACGACGGCATAATTGATCGCAGCCCGACCA|TGTCATCCGCTAGGGAAAACATAGTTGGCC
TGTCTAAAACATTACAGAACCAGTGCAGGC|GCGTTCCGGTTAGGAATCACCTTTCGCATG
TGAGCTCGTCTGAGGTCGTATAGCTGTCGC|CTGGTTTATATTAGTGGAGGTTGTAGTTGC
GTGCAATAATGCCAAACAAGCTGTCTAATA|GTGCAATAATGCCAAACAAGCTGTCTAATA
AATGCCAAACAAGCTGTCTAAACTGCATGT|GCTCGTTAATGCCACCCAGATGGGTGCGCC
AAACAAGCTGTCTAATAGCCCTATACAGGT|TCGCAGCCCGACCATGCTCGTAATCTGTCC
GCGGCCCAACTAGCACCCATAACTCGTTTG|GTGCGCCGTTTTGAGTATACCGTTGACCTT
CGCTAGATGCATTTAAGTTGTGCAATAATG|GCTGTCTAATAAGCGATTGTAGCTTGTGCA
ACGCAGCTGACGACGGCATAATTGATCGCA|AGCCTTTGCTGTCATCCGCTAGGGAAAACA
ATAATGCCAAACAAGCTGTCTAAAATGTGT|GCTGTCTAAAATGCCAAACAAGCTGTCTAA
GGCTGCACTGCAAATTTGCCGTCAAGCGCC|ATACACCAGCTTGAGCTCGTCTGAGGTCGT
GTTCGTCTCTGGCCTGACCAGTGCACCATG|CTCGTTAACGCTGCCTGGTAGGGCTGCACT
GTTACTGGTTTATATTAGTGGAGGTTGTAG|CAGTTTCGGAAGCTGCGAACTGTTCGTCGC
AATGCCAAACAAGCTGTCTAAACACGATCA|ATAATGCGAAGCAGCTCAATGGTTTACCAG
ATGGTTTACCAGTATTTTCGTTACTGGTTT|ACAGAACCAGTGCAGGCGCCAGTTTCGGAA
ACTCTGACCGGACGCAGCTGACGACGGCAT|TGGCGATAAAGAGCCTTTGCTGTCATCCGC
GCACCTCTCGTCTCGTTAACGCTGCCTGGT|ATAATGCCAAACAAGCTGTCTAAACACGAT
CGGCGATAACGGTAGTTCCGTTGTGCAATA|CTCTGACCGGACGCAGCTGACGACGGCATA
GTAGTTGCAACTGTGGAAAGGTGCGCCGTT|TCGCGGGTTTTATTGTTGTGCAATAATGCC
TGCACTCTCCACGACTCTGACCGGACGCAG|TCTAAACTGCATGTGGCGATAAAGAGCCTT
GTCTAAAATGCCAAACAAGCTGTCTAAGAC|AAAGGGGGATACATCTTAGTGCACTCTCCA
TAATGCCAAACAAGCTGTCTTGTGCAATAA|GGCGATAACGGTAGTTCCGTTGTGCAATAA
CTAAACTGCATGTGGCGATAAAGAGCCTTT|AGATGGGTGCGCCTCAAGCGAGAAGTGGGA
GATCAATACACCAGCTTGAGCTCGTCTGAG|ACCAGTATTTTCGTTACTGGTTTATATTAG
TTCCGTTGTGCAATAATGCCAAACAAGCTG|GCTGACGACGGCATAATTGATCGCAGCCCG
AGACATGCGGCGATAACGGTAGTTCCGTTG|TCCACGACTCTGACCGGACGCAGCTGACGA
ATCTGTCCACTTTCGACCCGTAGCCTCATC|AACGTTCACTGCAGATGGATCTGGCGTCTA
ATGTGTTGTGCAATAATGCCAAACAAGCTG|GTCTAAGACATGCGGCGATAACGGTAGTTC
GTAGTTCCGTTGTGCAATAATGCCAAACAA|CGCAGCTGACGACGGCATAATTGATCGCAG
AATGCCAAACAAGCTGTCTAATAAGCGATT|AATGCCAAACAAGCTGTCTAATAGCCCTAT
TAATGCCAAACAAGCTGTCTAAGGAAGTCC|CCGGAAGAGAAGTGTGGCTTCGGCTCCCAG
CTGTCTTGTGCAATAATGCCAAACAAGCTG|TTCCGTTGTGCAATAATGCCAAACAAGCTG
CCGACTGGTAGCGTTCGTCTCTGGCCTGAC|AGCACCTCTCGTCTCGTTAACGCTGCCTGG
GTGCAATTTGTGCAATAATGCCAAACAAGC|CCGTTGTGCAATAATGCCAAACAAGCTGTC
GCCAGGTGCCCTCCACCAGCTATCACGGGA|GATAAGGACGGGACTAAGGCATTCGTTTCA
AAGCGATTGTAGCTTGTGCAATTTGTGCAA|AGCCCTATACAGGTGCCGTTGTGCAATAAT
CGACTCTGACCGGACGCAGCTGACGACGGC|TGTGGCGATAAAGAGCCTTTGCTGTCATCC
CGTTGTGCAATAATGCCAAACAAGCTGTCT|GACGACGGCATAATTGATCGCAGCCCGACC
CTGTCTAAAATGTGTTGTGCAATAATGCCA|AAACAAGCTGTCTAAGACATGCGGCGATAA
ATGCCAAACAAGCTGTCTAAACTGCATGTG|CTCGTTAATGCCACCCAGATGGGTGCGCCT
CAATAATGCCAAACAAGCTGTCTAAAATGC|AATGCCAAACAAGCTGTCTAAAGGGGGATA
CCGTAGCCTCATCTGTTTTGTGCAATAATG|GATCTGGCGTCTACCCGCGCCAGATTGCTC
CGAACTGTTCGTCGCGGGTTTTATTGTTGT|AGTTGTGCAATAATGCCAAACAAGCTGTCT
ATTGTCTAACGTGCCGAACACTTTGTGCAA|CCATAACTCGTTTGGGAGTTTATCGTTCAG
ACAAGCTGTCTAAACTGCATGTGGCGATAA|ATGCCACCCAGATGGGTGCGCCTCAAGCGA
GATAATGCGAAGCAGCTCAATGGTTTACCA|ACAAGCTGTCTAAAACATTACAGAACCAGT
GAAGAGAAGTGTGGCTTCGGCTCCCAGCAC|GTCTAACGTGCCGAACACTTTGTGCAATAA
CATTTAAGTTGTGCAATAATGCCAAACAAG|TAAGCGATTGTAGCTTGTGCAATTTGTGCA
GTCACCGTTTGATAAGGACGGGACTAAGGC|AAATTTGCCGTCAAGCGCCGATTAGAATTG
TTGTGCAATAATGCCAAACAAGCTGTCTAA|GTCTATTGTGCAATAATGCCAAACAAGCTG
GTGCAATAATGCCAAACAAGCTGTCTAAAA|AATGCCAAACAAGCTGTCTAAGCGTTCCGG
CCACGACTCTGACCGGACGCAGCTGACGAC|GCATGTGGCGATAAAGAGCCTTTGCTGTCA
GCAATAATGCCAAACAAGCTGTCTAATAAG|GCAATAATGCCAAACAAGCTGTCTAATAGC
AAAGGGGGATACATCTTAGTGCACTCTCCA|AATAATGCCAAACAAGCTGTCTAAACTGCA
TGGAGGTTGTAGTTGCAACTGTGGAAAGGT|ACTGTTCGTCGCGGGTTTTATTGTTGTGCA
AATAATGCCAAACAAGCTGTCTAACATTGT|ACCCTAGACGCGGCCCAACTAGCACCCATA
GTCTAAGACATGCGGCGATAACGGTAGTTC|CACTCTCCACGACTCTGACCGGACGCAGCT
TGCGAACTGTTCGTCGCGGGTTTTATTGTT|TAAGTTGTGCAATAATGCCAAACAAGCTGT
AATGCCAAACAAGCTGTCTAAAGGGGGATA|AGCCTCATCTGTTTTGTGCAATAATGCCAA
ATGCGGCGATAACGGTAGTTCCGTTGTGCA|CGACTCTGACCGGACGCAGCTGACGACGGC
GAACACTTTGTGCAATAATGCCAAACAAGC|GAGTTTATCGTTCAGGATAATGCGAAGCAG
TAATGCCAAACAAGCTGTCTAAACACGATC|GATAATGCGAAGCAGCTCAATGGTTTACCA
TCGACCCGTAGCCTCATCTGTTTTGTGCAA|AGATGGATCTGGCGTCTACCCGCGCCAGAT
AGCCCTATACAGGTGCCGTTGTGCAATAAT|CTCGTAATCTGTCCACTTTCGACCCGTAGC
TAGTGGAGGTTGTAGTTGCAACTGTGGAAA|CGAACTGTTCGTCGCGGGTTTTATTGTTGT
CTGTCTAAAGGGGGATACATCTTAGTGCAC|TTGTGCAATAATGCCAAACAAGCTGTCTAA
CTTGAGCTCGTCTGAGGTCGTATAGCTGTC|TACTGGTTTATATTAGTGGAGGTTGTAGTT
CAGGTGCCGTTGTGCAATAATGCCAAACAA|TGTCCACTTTCGACCCGTAGCCTCATCTGT
GTGTCACCGTTTGATAAGGACGGGACTAAG|GCAAATTTGCCGTCAAGCGCCGATTAGAAT
CAAGCGCCGATTAGAATTGTGCAATAATGC|GAGGTCGTATAGCTGTCGCGAAACCCTAGA
TGCCAAACAAGCTGTCTAAAGGGGGATACA|CCTCATCTGTTTTGTGCAATAATGCCAAAC
CCGTTGTGCAATAATGCCAAACAAGCTGTC|TGACGACGGCATAATTGATCGCAGCCCGAC
CTCGTCTGAGGTCGTATAGCTGTCGCGAAA|TTTATATTAGTGGAGGTTGTAGTTGCAACT
CACCTTTCGCATGGACGCTAGATGCATTTA|AATAATGCCAAACAAGCTGTCTAATAAGCG
AATTTGCCGTCAAGCGCCGATTAGAATTGT|GAGCTCGTCTGAGGTCGTATAGCTGTCGCG
AGCTCAATGGTTTACCAGTATTTTCGTTAC|AACATTACAGAACCAGTGCAGGCGCCAGTT
GTGCAATAATGCCAAACAAGCTGTCTATTG|TAGCTTGTGCAATTTGTGCAATAATGCCAA
TGACCTTTGTGCAATAATGCCAAACAAGCT|AATGCAATAATGCCAAACAAGCTGTCTAAG
ATGCCAAACAAGCTGTCTAAAATGTGTTGT|GTCTAAAATGCCAAACAAGCTGTCTAAGAC
GCGGCGATAACGGTAGTTCCGTTGTGCAAT|ACTCTGACCGGACGCAGCTGACGACGGCAT
CCACTTTCGACCCGTAGCCTCATCTGTTTT|CACTGCAGATGGATCTGGCGTCTACCCGCG
CATAATTGATCGCAGCCCGACCATGCTCGT|CGCTAGGGAAAACATAGTTGGCCAGGTAGA
CACTTTGTGCAATAATGCCAAACAAGCTGT|TTTATCGTTCAGGATAATGCGAAGCAGCTC
CTATTGTGCAATAATGCCAAACAAGCTGTC|TGCCAAACAAGCTGTCTAAAATGCCAAACA
CCAGTGCACCATGGTGTCACCGTTTGATAA|GTAGGGCTGCACTGCAAATTTGCCGTCAAG
TTTGCTGTCATCCGCTAGGGAAAACATAGT|GGATTAGTATAACAGAGTCCCCAGAGAGTT
CTGTCTAAACTGCATGTGGCGATAAAGAGC|ACCCAGATGGGTGCGCCTCAAGCGAGAAGT
TGCAGGCGCCAGTTTCGGAAGCTGCGAACT|TCGCATGGACGCTAGATGCATTTAAGTTGT
TCTAAGGAAGTCCGACTGGTAGCGTTCGTC|CTTCGGCTCCCAGCACCTCTCGTCTCGTTA
AATAATGCCAAACAAGCTGTCTAAGGAAGT|AACCGGAAGAGAAGTGTGGCTTCGGCTCCC
TCGTTACTGGTTTATATTAGTGGAGGTTGT|GCCAGTTTCGGAAGCTGCGAACTGTTCGTC
ACACTTTGTGCAATAATGCCAAACAAGCTG|GTTTATCGTTCAGGATAATGCGAAGCAGCT
AGCTGCGAACTGTTCGTCGCGGGTTTTATT|ATTTAAGTTGTGCAATAATGCCAAACAAGC
AGTATACCGTTGACCTTTGTGCAATAATGC|CAAGCTGTCTAATGCAATAATGCCAAACAA
CTGTCATCCGCTAGGGAAAACATAGTTGGC|TAGTATAACAGAGTCCCCAGAGAGTTGGTT
ATGGACGCTAGATGCATTTAAGTTGTGCAA|AACAAGCTGTCTAATAAGCGATTGTAGCTT
AGCTGTCTAAGACATGCGGCGATAACGGTA|AGTGCACTCTCCACGACTCTGACCGGACGC
TCGTTTGGGAGTTTATCGTTCAGGATAATG|TGACCTTTGTGCAATAATGCCAAACAAGCT
GTCTAATGCAATAATGCCAAACAAGCTGTC|AAGCTGTCTAAAATGTGTTGTGCAATAATG
CGTCTGAGGTCGTATAGCTGTCGCGAAACC|TATATTAGTGGAGGTTGTAGTTGCAACTGT
TCCACCAGCTATCACGGGAGATCTTACTTT|GACTAAGGCATTCGTTTCATGTACTCGGAT
GCAGCTCAATGGTTTACCAGTATTTTCGTT|AAAACATTACAGAACCAGTGCAGGCGCCAG
ACATAGTTGGCCAGGTAGAGAACGTTCACT|GAGAGTTGGTTTGTCGCGTAAGGCCAACTC
ATTTAAGTTGTGCAATAATGCCAAACAAGC|AAGCGATTGTAGCTTGTGCAATTTGTGCAA
CAATAATGCCAAACAAGCTGTCTAAACACG|CAGGATAATGCGAAGCAGCTCAATGGTTTA
GTCGCGGGTTTTATTGTTGTGCAATAATGC|TAATGCCAAACAAGCTGTCTATTGTGCAAT
AGGTGCCGTTGTGCAATAATGCCAAACAAG|GTCCACTTTCGACCCGTAGCCTCATCTGTT
TCACCGTTTGATAAGGACGGGACTAAGGCA|AATTTGCCGTCAAGCGCCGATTAGAATTGT
ACTCGGATGCGCTAACCGGAAGAGAAGTGT|AACAAGCTGTCTAACATTGTCTAACGTGCC
ATTTGCCGTCAAGCGCCGATTAGAATTGTG|AGCTCGTCTGAGGTCGTATAGCTGTCGCGA
TAATCTGTCCACTTTCGACCCGTAGCCTCA|AGAACGTTCACTGCAGATGGATCTGGCGTC
GTTTTATTGTTGTGCAATAATGCCAAACAA|AAACAAGCTGTCTATTGTGCAATAATGCCA
GTTTGGGAGTTTATCGTTCAGGATAATGCG|ACCTTTGTGCAATAATGCCAAACAAGCTGT
AATAATGCCAAACAAGCTGTCTAAAATGCC|ATGCCAAACAAGCTGTCTAAAGGGGGATAC
GTGCAATAATGCCAAACAAGCTGTCTTGTG|ACATGCGGCGATAACGGTAGTTCCGTTGTG
GCTGTCGCGAAACCCTAGACGCGGCCCAAC|GTAGTTGCAACTGTGGAAAGGTGCGCCGTT
TAGTTGCAACTGTGGAAAGGTGCGCCGTTT|CGCGGGTTTTATTGTTGTGCAATAATGCCA
GGACGCTAGATGCATTTAAGTTGTGCAATA|CAAGCTGTCTAATAAGCGATTGTAGCTTGT
AAACAAGCTGTCTAAGGAAGTCCGACTGGT|AGAAGTGTGGCTTCGGCTCCCAGCACCTCT
ATAATGCCAAACAAGCTGTCTAAAACATTA|CAAACAAGCTGTCTAAGCGTTCCGGTTAGG
TGTCTAAAATGTGTTGTGCAATAATGCCAA|AACAAGCTGTCTAAGACATGCGGCGATAAC
CGGCTCCCAGCACCTCTCGTCTCGTTAACG|CTTTGTGCAATAATGCCAAACAAGCTGTCT
TCGCGAAACCCTAGACGCGGCCCAACTAGC|TTGCAACTGTGGAAAGGTGCGCCGTTTTGA
TAAAACATTACAGAACCAGTGCAGGCGCCA|TCCGGTTAGGAATCACCTTTCGCATGGACG
CGGGACTAAGGCATTCGTTTCATGTACTCG|CGATTAGAATTGTGCAATAATGCCAAACAA
AATAATGCCAAACAAGCTGTCTAAAATGTG|AGCTGTCTAAAATGCCAAACAAGCTGTCTA
AACAAGCTGTCTAAGACATGCGGCGATAAC|TCTTAGTGCACTCTCCACGACTCTGACCGG
TAAAATGCCAAACAAGCTGTCTAAGACATG|GGGGGATACATCTTAGTGCACTCTCCACGA
ATCGCAGCCCGACCATGCTCGTAATCTGTC|AAAACATAGTTGGCCAGGTAGAGAACGTTC
ACCATGGTGTCACCGTTTGATAAGGACGGG|TGCACTGCAAATTTGCCGTCAAGCGCCGAT
CCTATACAGGTGCCGTTGTGCAATAATGCC|GTAATCTGTCCACTTTCGACCCGTAGCCTC
TACTCGGATGCGCTAACCGGAAGAGAAGTG|AAACAAGCTGTCTAACATTGTCTAACGTGC
ACTAGCACCCATAACTCGTTTGGGAGTTTA|TTTTGAGTATACCGTTGACCTTTGTGCAAT
AGGCATTCGTTTCATGTACTCGGATGCGCT|ATTGTGCAATAATGCCAAACAAGCTGTCTA
GCGCCGATTAGAATTGTGCAATAATGCCAA|GTCGTATAGCTGTCGCGAAACCCTAGACGC
CGTCAAGCGCCGATTAGAATTGTGCAATAA|TCTGAGGTCGTATAGCTGTCGCGAAACCCT
CAAGCTGTCTAAAATGCCAAACAAGCTGTC|CTGTCTAAAGGGGGATACATCTTAGTGCAC
GGACGCAGCTGACGACGGCATAATTGATCG|AGAGCCTTTGCTGTCATCCGCTAGGGAAAA
TCTGCCAGGTGCCCTCCACCAGCTATCACG|TTTGATAAGGACGGGACTAAGGCATTCGTT
GTGCAATAATGCCAAACAAGCTGTCTAATA|ACGGCATAATTGATCGCAGCCCGACCATGC
TAAGGAAGTCCGACTGGTAGCGTTCGTCTC|TCGGCTCCCAGCACCTCTCGTCTCGTTAAC
AAGCTGTCTAATGCAATAATGCCAAACAAG|CAAACAAGCTGTCTAAAATGTGTTGTGCAA
CAATGGTTTACCAGTATTTTCGTTACTGGT|TTACAGAACCAGTGCAGGCGCCAGTTTCGG
ATAATGCCAAACAAGCTGTCTAAGGAAGTC|ACCGGAAGAGAAGTGTGGCTTCGGCTCCCA
TGGTAGCGTTCGTCTCTGGCCTGACCAGTG|CTCTCGTCTCGTTAACGCTGCCTGGTAGGG
TTGGGAGTTTATCGTTCAGGATAATGCGAA|CTTTGTGCAATAATGCCAAACAAGCTGTCT
TTCCGGTTAGGAATCACCTTTCGCATGGAC|AAGCTGTCTTGTGCAATAATGCCAAACAAG
CTAATAGCCCTATACAGGTGCCGTTGTGCA|CCATGCTCGTAATCTGTCCACTTTCGACCC
TCTATTGTGCAATAATGCCAAACAAGCTGT|ATGCCAAACAAGCTGTCTAAAATGCCAAAC
TGTTCGTCGCGGGTTTTATTGTTGTGCAAT|TGCAATAATGCCAAACAAGCTGTCTATTGT
ACATTACAGAACCAGTGCAGGCGCCAGTTT|GTTAGGAATCACCTTTCGCATGGACGCTAG
AAACAAGCTGTCTAAAACATTACAGAACCA|CTGTCTAAGCGTTCCGGTTAGGAATCACCT
GCAATAATGCCAAACAAGCTGTCTAAAATG|TAATGCCAAACAAGCTGTCTAAAGGGGGAT
CAAGCTGTCTTGTGCAATAATGCCAAACAA|GTAGTTCCGTTGTGCAATAATGCCAAACAA
AGTGTGGCTTCGGCTCCCAGCACCTCTCGT|GTGCCGAACACTTTGTGCAATAATGCCAAA
ACTGTGGAAAGGTGCGCCGTTTTGAGTATA|TTATTGTTGTGCAATAATGCCAAACAAGCT
GAGGTTGTAGTTGCAACTGTGGAAAGGTGC|TGTTCGTCGCGGGTTTTATTGTTGTGCAAT
GTGCAGGCGCCAGTTTCGGAAGCTGCGAAC|TTCGCATGGACGCTAGATGCATTTAAGTTG
CTGACCGGACGCAGCTGACGACGGCATAAT|CGATAAAGAGCCTTTGCTGTCATCCGCTAG
TGTTGTGCAATAATGCCAAACAAGCTGTCT|CTGTCTATTGTGCAATAATGCCAAACAAGC
GTGCAATAATGCCAAACAAGCTGTCTAAAC|CCAGATTGCTCGTTAATGCCACCCAGATGG
AACAAGCTGTCTAAGCGTTCCGGTTAGGAA|GTGCAATAATGCCAAACAAGCTGTCTTGTG
TGCGCTAACCGGAAGAGAAGTGTGGCTTCG|TGTCTAACATTGTCTAACGTGCCGAACACT
ACGCTGCCTGGTAGGGCTGCACTGCAAATT|TCTAAACACGATCAATACACCAGCTTGAGC
CTAGATGCATTTAAGTTGTGCAATAATGCC|TGTCTAATAAGCGATTGTAGCTTGTGCAAT
CTCTCGTCTCGTTAACGCTGCCTGGTAGGG|TGCCAAACAAGCTGTCTAAACACGATCAAT
CTAAGGAAGTCCGACTGGTAGCGTTCGTCT|TTCGGCTCCCAGCACCTCTCGTCTCGTTAA
ATTGTAGCTTGTGCAATTTGTGCAATAATG|TATACAGGTGCCGTTGTGCAATAATGCCAA
GTGCAATAATGCCAAACAAGCTGTCTAAAA|AACAAGCTGTCTAAAATGCCAAACAAGCTG
GTGCAATAATGCCAAACAAGCTGTCTAAGG|CGCTAACCGGAAGAGAAGTGTGGCTTCGGC
ACCTCTCGTCTCGTTAACGCTGCCTGGTAG|AATGCCAAACAAGCTGTCTAAACACGATCA
CAACTAGCACCCATAACTCGTTTGGGAGTT|CGTTTTGAGTATACCGTTGACCTTTGTGCA
AAATGTGTTGTGCAATAATGCCAAACAAGC|CTGTCTAAGACATGCGGCGATAACGGTAGT
GACGGCATAATTGATCGCAGCCCGACCATG|TCATCCGCTAGGGAAAACATAGTTGGCCAG
CTGTCTAATGCAATAATGCCAAACAAGCTG|ACAAGCTGTCTAAAATGTGTTGTGCAATAA
TGCCAAACAAGCTGTCTAATAAGCGATTGT|TGCCAAACAAGCTGTCTAATAGCCCTATAC
TTGTGCAATAATGCCAAACAAGCTGTCTAA|CGCGAAACCCTAGACGCGGCCCAACTAGCA
CTAAAGGGGGATACATCTTAGTGCACTCTC|GCAATAATGCCAAACAAGCTGTCTAAACTG
CATTACAGAACCAGTGCAGGCGCCAGTTTC|TTAGGAATCACCTTTCGCATGGACGCTAGA
CCATGCTCGTAATCTGTCCACTTTCGACCC|GCCAGGTAGAGAACGTTCACTGCAGATGGA
GCACCCATAACTCGTTTGGGAGTTTATCGT|GAGTATACCGTTGACCTTTGTGCAATAATG
AAGGACGGGACTAAGGCATTCGTTTCATGT|AGCGCCGATTAGAATTGTGCAATAATGCCA
GTCCGACTGGTAGCGTTCGTCTCTGGCCTG|CCAGCACCTCTCGTCTCGTTAACGCTGCCT
ACGTGCCGAACACTTTGTGCAATAATGCCA|CGTTTGGGAGTTTATCGTTCAGGATAATGC
GGTCGTATAGCTGTCGCGAAACCCTAGACG|GTGGAGGTTGTAGTTGCAACTGTGGAAAGG
CTAACCGGAAGAGAAGTGTGGCTTCGGCTC|TAACATTGTCTAACGTGCCGAACACTTTGT
GCACTGCAAATTTGCCGTCAAGCGCCGATT|ACCAGCTTGAGCTCGTCTGAGGTCGTATAG
CAAATTTGCCGTCAAGCGCCGATTAGAATT|TTGAGCTCGTCTGAGGTCGTATAGCTGTCG
CCAACTAGCACCCATAACTCGTTTGGGAGT|CCGTTTTGAGTATACCGTTGACCTTTGTGC
TGGTTTATATTAGTGGAGGTTGTAGTTGCA|TCGGAAGCTGCGAACTGTTCGTCGCGGGTT
CCAGCTTGAGCTCGTCTGAGGTCGTATAGC|TCGTTACTGGTTTATATTAGTGGAGGTTGT
AGGGGGATACATCTTAGTGCACTCTCCACG|TAATGCCAAACAAGCTGTCTAAACTGCATG
GCGTTCGTCTCTGGCCTGACCAGTGCACCA|GTCTCGTTAACGCTGCCTGGTAGGGCTGCA
GACTCTGACCGGACGCAGCTGACGACGGCA|GTGGCGATAAAGAGCCTTTGCTGTCATCCG
TGCCAGGTGCCCTCCACCAGCTATCACGGG|TGATAAGGACGGGACTAAGGCATTCGTTTC
CTCCACGACTCTGACCGGACGCAGCTGACG|CTGCATGTGGCGATAAAGAGCCTTTGCTGT
CATGGACGCTAGATGCATTTAAGTTGTGCA|AAACAAGCTGTCTAATAAGCGATTGTAGCT
AAGGTGCGCCGTTTTGAGTATACCGTTGAC|GTGCAATAATGCCAAACAAGCTGTCTAATG
ACGCTAGATGCATTTAAGTTGTGCAATAAT|AGCTGTCTAATAAGCGATTGTAGCTTGTGC
GCCTGACCAGTGCACCATGGTGTCACCGTT|TGCCTGGTAGGGCTGCACTGCAAATTTGCC
GCTAGGGAAAACATAGTTGGCCAGGTAGAG|AGAGTCCCCAGAGAGTTGGTTTGTCGCGTA
TTTGATAAGGACGGGACTAAGGCATTCGTT|CCGTCAAGCGCCGATTAGAATTGTGCAATA
CTCGTAATCTGTCCACTTTCGACCCGTAGC|GTAGAGAACGTTCACTGCAGATGGATCTGG
TAACCGGAAGAGAAGTGTGGCTTCGGCTCC|AACATTGTCTAACGTGCCGAACACTTTGTG
TACAGAACCAGTGCAGGCGCCAGTTTCGGA|GGAATCACCTTTCGCATGGACGCTAGATGC
GTGGAAAGGTGCGCCGTTTTGAGTATACCG|TTGTTGTGCAATAATGCCAAACAAGCTGTC
TTAGAATTGTGCAATAATGCCAAACAAGCT|AGCTGTCGCGAAACCCTAGACGCGGCCCAA
CCGTTGTGCAATAATGCCAAACAAGCTGTC|CTTTCGACCCGTAGCCTCATCTGTTTTGTG
CTGTTCGTCGCGGGTTTTATTGTTGTGCAA|GTGCAATAATGCCAAACAAGCTGTCTATTG
CAAACAAGCTGTCTAAAATGCCAAACAAGC|CAAGCTGTCTAAAGGGGGATACATCTTAGT
CGCCAGTTTCGGAAGCTGCGAACTGTTCGT|GGACGCTAGATGCATTTAAGTTGTGCAATA
GCGCCGTTTTGAGTATACCGTTGACCTTTG|ATAATGCCAAACAAGCTGTCTAATGCAATA
TATTAGTGGAGGTTGTAGTTGCAACTGTGG|CTGCGAACTGTTCGTCGCGGGTTTTATTGT
GCTCGTCTGAGGTCGTATAGCTGTCGCGAA|GTTTATATTAGTGGAGGTTGTAGTTGCAAC
GTTTCATGTACTCGGATGCGCTAACCGGAA|ATAATGCCAAACAAGCTGTCTAACATTGTC
GAGTATACCGTTGACCTTTGTGCAATAATG|ACAAGCTGTCTAATGCAATAATGCCAAACA
CAAACAAGCTGTCTAATAAGCGATTGTAGC|CAAACAAGCTGTCTAATAGCCCTATACAGG
AGGACGGGACTAAGGCATTCGTTTCATGTA|GCGCCGATTAGAATTGTGCAATAATGCCAA
AATAATGCCAAACAAGCTGTCTAATAAGCG|AATAATGCCAAACAAGCTGTCTAATAGCCC
ACAAGCTGTCTAAGGAAGTCCGACTGGTAG|AAGTGTGGCTTCGGCTCCCAGCACCTCTCG
TACAGGTGCCGTTGTGCAATAATGCCAAAC|TCTGTCCACTTTCGACCCGTAGCCTCATCT
ACAAGCTGTCTAAAATGTGTTGTGCAATAA|ATGCCAAACAAGCTGTCTAAGACATGCGGC
GAAAGGTGCGCCGTTTTGAGTATACCGTTG|TTGTGCAATAATGCCAAACAAGCTGTCTAA
ATGCAATAATGCCAAACAAGCTGTCTAAGC|GTCTAAAATGTGTTGTGCAATAATGCCAAA
GCCAGTTTCGGAAGCTGCGAACTGTTCGTC|GACGCTAGATGCATTTAAGTTGTGCAATAA
CCGTTGACCTTTGTGCAATAATGCCAAACA|GTCTAATGCAATAATGCCAAACAAGCTGTC
GTGGCTTCGGCTCCCAGCACCTCTCGTCTC|CCGAACACTTTGTGCAATAATGCCAAACAA
GCTCCCAGCACCTCTCGTCTCGTTAACGCT|TTGTGCAATAATGCCAAACAAGCTGTCTAA
CTCTCCACGACTCTGACCGGACGCAGCTGA|AACTGCATGTGGCGATAAAGAGCCTTTGCT
CTAATGCAATAATGCCAAACAAGCTGTCTA|GCTGTCTAAAATGTGTTGTGCAATAATGCC
GGATAATGCGAAGCAGCTCAATGGTTTACC|AACAAGCTGTCTAAAACATTACAGAACCAG
TCTGGCCTGACCAGTGCACCATGGTGTCAC|ACGCTGCCTGGTAGGGCTGCACTGCAAATT
AATAGCCCTATACAGGTGCCGTTGTGCAAT|ATGCTCGTAATCTGTCCACTTTCGACCCGT
TGCAACTGTGGAAAGGTGCGCCGTTTTGAG|GGTTTTATTGTTGTGCAATAATGCCAAACA
TGTCTAAACACGATCAATACACCAGCTTGA|CTCAATGGTTTACCAGTATTTTCGTTACTG
CGTTTGATAAGGACGGGACTAAGGCATTCG|TGCCGTCAAGCGCCGATTAGAATTGTGCAA
AATGCCAAACAAGCTGTCTAAGACATGCGG|GGATACATCTTAGTGCACTCTCCACGACTC
GTTTATATTAGTGGAGGTTGTAGTTGCAAC|GGAAGCTGCGAACTGTTCGTCGCGGGTTTT
AAACAAGCTGTCTAAAATGTGTTGTGCAAT|AAATGCCAAACAAGCTGTCTAAGACATGCG
TTTGTGCAATAATGCCAAACAAGCTGTCTA|GCGCCAGATTGCTCGTTAATGCCACCCAGA
GCAGCCCGACCATGCTCGTAATCTGTCCAC|ACATAGTTGGCCAGGTAGAGAACGTTCACT
ATGCCAAACAAGCTGTCTTGTGCAATAATG|CGATAACGGTAGTTCCGTTGTGCAATAATG
ACAAGCTGTCTAAAACATTACAGAACCAGT|GTCTAAGCGTTCCGGTTAGGAATCACCTTT
GTTTGATAAGGACGGGACTAAGGCATTCGT|GCCGTCAAGCGCCGATTAGAATTGTGCAAT
GTCTAAAGGGGGATACATCTTAGTGCACTC|GTGCAATAATGCCAAACAAGCTGTCTAAAC
TACTGGTTTATATTAGTGGAGGTTGTAGTT|GTTTCGGAAGCTGCGAACTGTTCGTCGCGG
TGACGACGGCATAATTGATCGCAGCCCGAC|GCTGTCATCCGCTAGGGAAAACATAGTTGG
GCAATAATGCCAAACAAGCTGTCTAACATT|AAACCCTAGACGCGGCCCAACTAGCACCCA
ATGCCAAACAAGCTGTCTATTGTGCAATAA|GCAATTTGTGCAATAATGCCAAACAAGCTG
AACTAGCACCCATAACTCGTTTGGGAGTTT|GTTTTGAGTATACCGTTGACCTTTGTGCAA
CGCGGCCCAACTAGCACCCATAACTCGTTT|GGTGCGCCGTTTTGAGTATACCGTTGACCT
AATAAGCGATTGTAGCTTGTGCAATTTGTG|AATAGCCCTATACAGGTGCCGTTGTGCAAT
AGAAGTGTGGCTTCGGCTCCCAGCACCTCT|AACGTGCCGAACACTTTGTGCAATAATGCC
TATACCGTTGACCTTTGTGCAATAATGCCA|AGCTGTCTAATGCAATAATGCCAAACAAGC
CAATACACCAGCTTGAGCTCGTCTGAGGTC|AGTATTTTCGTTACTGGTTTATATTAGTGG
GTGCCGAACACTTTGTGCAATAATGCCAAA|TTTGGGAGTTTATCGTTCAGGATAATGCGA
TGTGTTGTGCAATAATGCCAAACAAGCTGT|TCTAAGACATGCGGCGATAACGGTAGTTCC
GGGACTAAGGCATTCGTTTCATGTACTCGG|GATTAGAATTGTGCAATAATGCCAAACAAG
TGCGGCGATAACGGTAGTTCCGTTGTGCAA|GACTCTGACCGGACGCAGCTGACGACGGCA
TGTGGCGATAAAGAGCCTTTGCTGTCATCC|GCCTCAAGCGAGAAGTGGGATTAGTATAAC
TCTAATGCAATAATGCCAAACAAGCTGTCT|AGCTGTCTAAAATGTGTTGTGCAATAATGC
TTGTGCAATAATGCCAAACAAGCTGTCTAA|TCGTTCAGGATAATGCGAAGCAGCTCAATG
TGCAATAATGCCAAACAAGCTGTCTAAAGG|ACCCGTAGCCTCATCTGTTTTGTGCAATAA
GCCAAACAAGCTGTCTAAAACATTACAGAA|AAGCTGTCTAAGCGTTCCGGTTAGGAATCA
CAATAATGCCAAACAAGCTGTCTAAGGAAG|TAACCGGAAGAGAAGTGTGGCTTCGGCTCC
TGTGGCTTCGGCTCCCAGCACCTCTCGTCT|GCCGAACACTTTGTGCAATAATGCCAAACA
GTCTAAGGAAGTCCGACTGGTAGCGTTCGT|GCTTCGGCTCCCAGCACCTCTCGTCTCGTT
ACCAGCTTGAGCTCGTCTGAGGTCGTATAG|TTCGTTACTGGTTTATATTAGTGGAGGTTG
GCGAAGCAGCTCAATGGTTTACCAGTATTT|TGTCTAAAACATTACAGAACCAGTGCAGGC
GTATTTTCGTTACTGGTTTATATTAGTGGA|GCAGGCGCCAGTTTCGGAAGCTGCGAACTG
TGCACTGCAAATTTGCCGTCAAGCGCCGAT|CACCAGCTTGAGCTCGTCTGAGGTCGTATA
CGCTGCCTGGTAGGGCTGCACTGCAAATTT|CTAAACACGATCAATACACCAGCTTGAGCT
CCCTCCACCAGCTATCACGGGAGATCTTAC|CGGGACTAAGGCATTCGTTTCATGTACTCG
AAACATAGTTGGCCAGGTAGAGAACGTTCA|CAGAGAGTTGGTTTGTCGCGTAAGGCCAAC
TGTCATCCGCTAGGGAAAACATAGTTGGCC|AGTATAACAGAGTCCCCAGAGAGTTGGTTT
GAGCCTTTGCTGTCATCCGCTAGGGAAAAC|AAGTGGGATTAGTATAACAGAGTCCCCAGA
TTGTCTAACGTGCCGAACACTTTGTGCAAT|CATAACTCGTTTGGGAGTTTATCGTTCAGG
CATCTTAGTGCACTCTCCACGACTCTGACC|ACAAGCTGTCTAAACTGCATGTGGCGATAA
TAATGCCAAACAAGCTGTCTAAAGGGGGAT|TAGCCTCATCTGTTTTGTGCAATAATGCCA
ATAAAGAGCCTTTGCTGTCATCCGCTAGGG|GCGAGAAGTGGGATTAGTATAACAGAGTCC
GCCAAACAAGCTGTCTAACATTGTCTAACG|GACGCGGCCCAACTAGCACCCATAACTCGT
TAACATTGTCTAACGTGCCGAACACTTTGT|GCACCCATAACTCGTTTGGGAGTTTATCGT
GCAATAATGCCAAACAAGCTGTCTAAAACA|TGCCAAACAAGCTGTCTAAGCGTTCCGGTT
TAGCTTGTGCAATTTGTGCAATAATGCCAA|CAGGTGCCGTTGTGCAATAATGCCAAACAA
CTAAAATGCCAAACAAGCTGTCTAAGACAT|AGGGGGATACATCTTAGTGCACTCTCCACG
TCTAAACTGCATGTGGCGATAAAGAGCCTT|CAGATGGGTGCGCCTCAAGCGAGAAGTGGG
TCTAAAACATTACAGAACCAGTGCAGGCGC|GTTCCGGTTAGGAATCACCTTTCGCATGGA
TGTGCAATAATGCCAAACAAGCTGTCTAAA|CGACCCGTAGCCTCATCTGTTTTGTGCAAT
ACGACTCTGACCGGACGCAGCTGACGACGG|ATGTGGCGATAAAGAGCCTTTGCTGTCATC
GCATTTAAGTTGTGCAATAATGCCAAACAA|ATAAGCGATTGTAGCTTGTGCAATTTGTGC
ACTTTCGACCCGTAGCCTCATCTGTTTTGT|CTGCAGATGGATCTGGCGTCTACCCGCGCC
TCTAACATTGTCTAACGTGCCGAACACTTT|TAGCACCCATAACTCGTTTGGGAGTTTATC
TAGCCTCATCTGTTTTGTGCAATAATGCCA|CTGGCGTCTACCCGCGCCAGATTGCTCGTT
CAAACAAGCTGTCTAACATTGTCTAACGTG|CGCGGCCCAACTAGCACCCATAACTCGTTT
CTGTCTAAACACGATCAATACACCAGCTTG|GCTCAATGGTTTACCAGTATTTTCGTTACT
GATTGTAGCTTGTGCAATTTGTGCAATAAT|CTATACAGGTGCCGTTGTGCAATAATGCCA
TGCATGTGGCGATAAAGAGCCTTTGCTGTC|GTGCGCCTCAAGCGAGAAGTGGGATTAGTA
CTGAGGTCGTATAGCTGTCGCGAAACCCTA|ATTAGTGGAGGTTGTAGTTGCAACTGTGGA
AAAGAGCCTTTGCTGTCATCCGCTAGGGAA|GAGAAGTGGGATTAGTATAACAGAGTCCCC
GTTTCGGAAGCTGCGAACTGTTCGTCGCGG|CTAGATGCATTTAAGTTGTGCAATAATGCC
GAATCACCTTTCGCATGGACGCTAGATGCA|GTGCAATAATGCCAAACAAGCTGTCTAATA
CATTGTCTAACGTGCCGAACACTTTGTGCA|CCCATAACTCGTTTGGGAGTTTATCGTTCA
GTTGCAACTGTGGAAAGGTGCGCCGTTTTG|CGGGTTTTATTGTTGTGCAATAATGCCAAA
TGATCGCAGCCCGACCATGCTCGTAATCTG|GGAAAACATAGTTGGCCAGGTAGAGAACGT
TGCCAAACAAGCTGTCTAAACTGCATGTGG|TCGTTAATGCCACCCAGATGGGTGCGCCTC
CGCCGATTAGAATTGTGCAATAATGCCAAA|TCGTATAGCTGTCGCGAAACCCTAGACGCG
CGACGGCATAATTGATCGCAGCCCGACCAT|GTCATCCGCTAGGGAAAACATAGTTGGCCA
AGGGAAAACATAGTTGGCCAGGTAGAGAAC|GTCCCCAGAGAGTTGGTTTGTCGCGTAAGG
TTTGTGCAATAATGCCAAACAAGCTGTCTA|ATGCGCTAACCGGAAGAGAAGTGTGGCTTC
GGGAGATCTTACTTTTGTGCAATAATGCCA|TTCATGTACTCGGATGCGCTAACCGGAAGA
AGGCGCCAGTTTCGGAAGCTGCGAACTGTT|CATGGACGCTAGATGCATTTAAGTTGTGCA
ATCAATACACCAGCTTGAGCTCGTCTGAGG|CCAGTATTTTCGTTACTGGTTTATATTAGT
ATAATGCCAAACAAGCTGTCTAAACACGAT|GGATAATGCGAAGCAGCTCAATGGTTTACC
TGTTTTGTGCAATAATGCCAAACAAGCTGT|CCCGCGCCAGATTGCTCGTTAATGCCACCC
TGACCAGTGCACCATGGTGTCACCGTTTGA|CTGGTAGGGCTGCACTGCAAATTTGCCGTC
CTGTCTAAGACATGCGGCGATAACGGTAGT|TGCACTCTCCACGACTCTGACCGGACGCAG
CCCTATACAGGTGCCGTTGTGCAATAATGC|CGTAATCTGTCCACTTTCGACCCGTAGCCT
AAGCTGTCTAAAATGCCAAACAAGCTGTCT|TGTCTAAAGGGGGATACATCTTAGTGCACT
TAAGGCATTCGTTTCATGTACTCGGATGCG|GAATTGTGCAATAATGCCAAACAAGCTGTC
AAACAAGCTGTCTAAAGGGGGATACATCTT|ATCTGTTTTGTGCAATAATGCCAAACAAGC
TTTGAGTATACCGTTGACCTTTGTGCAATA|CAAACAAGCTGTCTAATGCAATAATGCCAA
CCGGACGCAGCTGACGACGGCATAATTGAT|AAAGAGCCTTTGCTGTCATCCGCTAGGGAA
TTTCGGAAGCTGCGAACTGTTCGTCGCGGG|TAGATGCATTTAAGTTGTGCAATAATGCCA
GCCCTATACAGGTGCCGTTGTGCAATAATG|TCGTAATCTGTCCACTTTCGACCCGTAGCC
TAATGCCAAACAAGCTGTCTAATGCAATAA|TGCAATAATGCCAAACAAGCTGTCTAAAAT
CTGACCAGTGCACCATGGTGTCACCGTTTG|CCTGGTAGGGCTGCACTGCAAATTTGCCGT
TGCCAAACAAGCTGTCTAATGCAATAATGC|AATAATGCCAAACAAGCTGTCTAAAATGTG
AAGCTGTCTTGTGCAATAATGCCAAACAAG|TAGTTCCGTTGTGCAATAATGCCAAACAAG
CACCAGCTATCACGGGAGATCTTACTTTTG|CTAAGGCATTCGTTTCATGTACTCGGATGC
TGTGCAATAATGCCAAACAAGCTGTCTAAC|GCGAAACCCTAGACGCGGCCCAACTAGCAC
GAGATCTTACTTTTGTGCAATAATGCCAAA|CATGTACTCGGATGCGCTAACCGGAAGAGA
TGCCGAACACTTTGTGCAATAATGCCAAAC|TTGGGAGTTTATCGTTCAGGATAATGCGAA
GTTGTGCAATAATGCCAAACAAGCTGTCTA|TTCGACCCGTAGCCTCATCTGTTTTGTGCA
CGTGCCGAACACTTTGTGCAATAATGCCAA|GTTTGGGAGTTTATCGTTCAGGATAATGCG
CAGTTTCGGAAGCTGCGAACTGTTCGTCGC|CGCTAGATGCATTTAAGTTGTGCAATAATG
TAAAGGGGGATACATCTTAGTGCACTCTCC|CAATAATGCCAAACAAGCTGTCTAAACTGC
TGTCTAAACTGCATGTGGCGATAAAGAGCC|CCCAGATGGGTGCGCCTCAAGCGAGAAGTG
ATCCGCTAGGGAAAACATAGTTGGCCAGGT|TAACAGAGTCCCCAGAGAGTTGGTTTGTCG
TGTGCAATTTGTGCAATAATGCCAAACAAG|GCCGTTGTGCAATAATGCCAAACAAGCTGT
GTGCGCCGTTTTGAGTATACCGTTGACCTT|CAATAATGCCAAACAAGCTGTCTAATGCAA
TCGGCTCCCAGCACCTCTCGTCTCGTTAAC|ACTTTGTGCAATAATGCCAAACAAGCTGTC
GTCTAAGCGTTCCGGTTAGGAATCACCTTT|ATGCCAAACAAGCTGTCTTGTGCAATAATG
AATTTGTGCAATAATGCCAAACAAGCTGTC|TGTGCAATAATGCCAAACAAGCTGTCTAAA
GCCAAACAAGCTGTCTAATAAGCGATTGTA|GCCAAACAAGCTGTCTAATAGCCCTATACA
CTGGTAGGGCTGCACTGCAAATTTGCCGTC|ACGATCAATACACCAGCTTGAGCTCGTCTG
GCATAATTGATCGCAGCCCGACCATGCTCG|CCGCTAGGGAAAACATAGTTGGCCAGGTAG
CTATACAGGTGCCGTTGTGCAATAATGCCA|TAATCTGTCCACTTTCGACCCGTAGCCTCA
CAATTTGTGCAATAATGCCAAACAAGCTGT|TTGTGCAATAATGCCAAACAAGCTGTCTAA
CAGAACCAGTGCAGGCGCCAGTTTCGGAAG|AATCACCTTTCGCATGGACGCTAGATGCAT
GGGGGATACATCTTAGTGCACTCTCCACGA|AATGCCAAACAAGCTGTCTAAACTGCATGT
TTGCTGTCATCCGCTAGGGAAAACATAGTT|GATTAGTATAACAGAGTCCCCAGAGAGTTG
GCTTGTGCAATTTGTGCAATAATGCCAAAC|GGTGCCGTTGTGCAATAATGCCAAACAAGC
AATAATGCCAAACAAGCTGTCTTGTGCAAT|GCGGCGATAACGGTAGTTCCGTTGTGCAAT
ACAAGCTGTCTAAGACATGCGGCGATAACG|CTTAGTGCACTCTCCACGACTCTGACCGGA
CGACCATGCTCGTAATCTGTCCACTTTCGA|TTGGCCAGGTAGAGAACGTTCACTGCAGAT
AAAATGTGTTGTGCAATAATGCCAAACAAG|GCTGTCTAAGACATGCGGCGATAACGGTAG
CTTGTGCAATTTGTGCAATAATGCCAAACA|GTGCCGTTGTGCAATAATGCCAAACAAGCT
ATACAGGTGCCGTTGTGCAATAATGCCAAA|ATCTGTCCACTTTCGACCCGTAGCCTCATC
TTTGTGCAATAATGCCAAACAAGCTGTCTA|TGCAATAATGCCAAACAAGCTGTCTAAAGG
TGTCTAAAGGGGGATACATCTTAGTGCACT|TGTGCAATAATGCCAAACAAGCTGTCTAAA
TGTCTAATAAGCGATTGTAGCTTGTGCAAT|TGTCTAATAGCCCTATACAGGTGCCGTTGT
AAGCTGTCTAAAATGTGTTGTGCAATAATG|GCCAAACAAGCTGTCTAAGACATGCGGCGA
GTCTGAGGTCGTATAGCTGTCGCGAAACCC|ATATTAGTGGAGGTTGTAGTTGCAACTGTG
TTCGTCGCGGGTTTTATTGTTGTGCAATAA|CAATAATGCCAAACAAGCTGTCTATTGTGC
CCAAACAAGCTGTCTAATAGCCCTATACAG|GATCGCAGCCCGACCATGCTCGTAATCTGT
CAACTGTGGAAAGGTGCGCCGTTTTGAGTA|TTTTATTGTTGTGCAATAATGCCAAACAAG
CAAACAAGCTGTCTAAACACGATCAATACA|GCGAAGCAGCTCAATGGTTTACCAGTATTT
AGGTTGTAGTTGCAACTGTGGAAAGGTGCG|GTTCGTCGCGGGTTTTATTGTTGTGCAATA
CATTCGTTTCATGTACTCGGATGCGCTAAC|GTGCAATAATGCCAAACAAGCTGTCTAACA
CACTCTCCACGACTCTGACCGGACGCAGCT|TAAACTGCATGTGGCGATAAAGAGCCTTTG
GGCCTGACCAGTGCACCATGGTGTCACCGT|CTGCCTGGTAGGGCTGCACTGCAAATTTGC
AAGTGTGGCTTCGGCTCCCAGCACCTCTCG|CGTGCCGAACACTTTGTGCAATAATGCCAA
CGTCGCGGGTTTTATTGTTGTGCAATAATG|ATAATGCCAAACAAGCTGTCTATTGTGCAA
CGTTCAGGATAATGCGAAGCAGCTCAATGG|ATGCCAAACAAGCTGTCTAAAACATTACAG
GGTGCCGTTGTGCAATAATGCCAAACAAGC|TCCACTTTCGACCCGTAGCCTCATCTGTTT
CAATAATGCCAAACAAGCTGTCTAAACTGC|GATTGCTCGTTAATGCCACCCAGATGGGTG
CTGTCTAATAGCCCTATACAGGTGCCGTTG|CCGACCATGCTCGTAATCTGTCCACTTTCG
ATGTACTCGGATGCGCTAACCGGAAGAGAA|GCCAAACAAGCTGTCTAACATTGTCTAACG
TTACTGGTTTATATTAGTGGAGGTTGTAGT|AGTTTCGGAAGCTGCGAACTGTTCGTCGCG
AATGCCAAACAAGCTGTCTAACATTGTCTA|CTAGACGCGGCCCAACTAGCACCCATAACT
TGCAATAATGCCAAACAAGCTGTCTATTGT|AGCTTGTGCAATTTGTGCAATAATGCCAAA
CACGGGAGATCTTACTTTTGTGCAATAATG|CGTTTCATGTACTCGGATGCGCTAACCGGA
TTGAGCTCGTCTGAGGTCGTATAGCTGTCG|ACTGGTTTATATTAGTGGAGGTTGTAGTTG
CTGCCTGGTAGGGCTGCACTGCAAATTTGC|AAACACGATCAATACACCAGCTTGAGCTCG
AGTATTTTCGTTACTGGTTTATATTAGTGG|TGCAGGCGCCAGTTTCGGAAGCTGCGAACT
TTAGTGGAGGTTGTAGTTGCAACTGTGGAA|GCGAACTGTTCGTCGCGGGTTTTATTGTTG
TACATCTTAGTGCACTCTCCACGACTCTGA|AAACAAGCTGTCTAAACTGCATGTGGCGAT
GATACATCTTAGTGCACTCTCCACGACTCT|CCAAACAAGCTGTCTAAACTGCATGTGGCG
TCTAAACACGATCAATACACCAGCTTGAGC|CAATGGTTTACCAGTATTTTCGTTACTGGT
CAATAATGCCAAACAAGCTGTCTAATAGCC|GCATAATTGATCGCAGCCCGACCATGCTCG
CTGCACTGCAAATTTGCCGTCAAGCGCCGA|ACACCAGCTTGAGCTCGTCTGAGGTCGTAT
TAACGGTAGTTCCGTTGTGCAATAATGCCA|CCGGACGCAGCTGACGACGGCATAATTGAT
AGCTGTCTAATAGCCCTATACAGGTGCCGT|GCCCGACCATGCTCGTAATCTGTCCACTTT
TGCTGTCATCCGCTAGGGAAAACATAGTTG|ATTAGTATAACAGAGTCCCCAGAGAGTTGG
CCAAACAAGCTGTCTAAAGGGGGATACATC|TCATCTGTTTTGTGCAATAATGCCAAACAA
CAAGCTGTCTAAAGGGGGATACATCTTAGT|TGTTTTGTGCAATAATGCCAAACAAGCTGT
CAAACAAGCTGTCTAAAATGTGTTGTGCAA|AAAATGCCAAACAAGCTGTCTAAGACATGC
CTAAGGCATTCGTTTCATGTACTCGGATGC|AGAATTGTGCAATAATGCCAAACAAGCTGT
CGCCGTTTTGAGTATACCGTTGACCTTTGT|TAATGCCAAACAAGCTGTCTAATGCAATAA
GCAATAATGCCAAACAAGCTGTCTAAAGGG|CCCGTAGCCTCATCTGTTTTGTGCAATAAT
CCGATTAGAATTGTGCAATAATGCCAAACA|GTATAGCTGTCGCGAAACCCTAGACGCGGC
GCTGTCTAAGGAAGTCCGACTGGTAGCGTT|GTGGCTTCGGCTCCCAGCACCTCTCGTCTC
TCTTACTTTTGTGCAATAATGCCAAACAAG|TACTCGGATGCGCTAACCGGAAGAGAAGTG
GTATACCGTTGACCTTTGTGCAATAATGCC|AAGCTGTCTAATGCAATAATGCCAAACAAG
GTCGTATAGCTGTCGCGAAACCCTAGACGC|TGGAGGTTGTAGTTGCAACTGTGGAAAGGT
AGGTGCGCCGTTTTGAGTATACCGTTGACC|TGCAATAATGCCAAACAAGCTGTCTAATGC
ATCGTTCAGGATAATGCGAAGCAGCTCAAT|TAATGCCAAACAAGCTGTCTAAAACATTAC
GTCTAAAATGTGTTGTGCAATAATGCCAAA|ACAAGCTGTCTAAGACATGCGGCGATAACG
GAAGTCCGACTGGTAGCGTTCGTCTCTGGC|CTCCCAGCACCTCTCGTCTCGTTAACGCTG
GTGCCCTCCACCAGCTATCACGGGAGATCT|GGACGGGACTAAGGCATTCGTTTCATGTAC
AACAAGCTGTCTAATAGCCCTATACAGGTG|CGCAGCCCGACCATGCTCGTAATCTGTCCA
GCGCCAGTTTCGGAAGCTGCGAACTGTTCG|TGGACGCTAGATGCATTTAAGTTGTGCAAT
GCCAAACAAGCTGTCTAATAGCCCTATACA|TGATCGCAGCCCGACCATGCTCGTAATCTG
TGTGCAATAATGCCAAACAAGCTGTCTAAA|AAACAAGCTGTCTAAAATGCCAAACAAGCT
GATAACGGTAGTTCCGTTGTGCAATAATGC|GACCGGACGCAGCTGACGACGGCATAATTG
AGCTGTCTTGTGCAATAATGCCAAACAAGC|AGTTCCGTTGTGCAATAATGCCAAACAAGC
ACTGGTTTATATTAGTGGAGGTTGTAGTTG|TTTCGGAAGCTGCGAACTGTTCGTCGCGGG
CTCGTCTCGTTAACGCTGCCTGGTAGGGCT|CCAAACAAGCTGTCTAAACACGATCAATAC
TCGTCGCGGGTTTTATTGTTGTGCAATAAT|AATAATGCCAAACAAGCTGTCTATTGTGCA
GTGCACTCTCCACGACTCTGACCGGACGCA|GTCTAAACTGCATGTGGCGATAAAGAGCCT
CTGTCTAAGCGTTCCGGTTAGGAATCACCT|TAATGCCAAACAAGCTGTCTTGTGCAATAA
TCTCGTTAACGCTGCCTGGTAGGGCTGCAC|ACAAGCTGTCTAAACACGATCAATACACCA
GTCTAACGTGCCGAACACTTTGTGCAATAA|TAACTCGTTTGGGAGTTTATCGTTCAGGAT
GGAGTTTATCGTTCAGGATAATGCGAAGCA|TGTGCAATAATGCCAAACAAGCTGTCTAAA
AACAAGCTGTCTTGTGCAATAATGCCAAAC|CGGTAGTTCCGTTGTGCAATAATGCCAAAC
TGGCTTCGGCTCCCAGCACCTCTCGTCTCG|CGAACACTTTGTGCAATAATGCCAAACAAG
TCTGTCCACTTTCGACCCGTAGCCTCATCT|ACGTTCACTGCAGATGGATCTGGCGTCTAC
CAAGCTGTCTAAAATGTGTTGTGCAATAAT|TGCCAAACAAGCTGTCTAAGACATGCGGCG
AACATTACAGAACCAGTGCAGGCGCCAGTT|GGTTAGGAATCACCTTTCGCATGGACGCTA
AAGAGCCTTTGCTGTCATCCGCTAGGGAAA|AGAAGTGGGATTAGTATAACAGAGTCCCCA
TGGCGATAAAGAGCCTTTGCTGTCATCCGC|CTCAAGCGAGAAGTGGGATTAGTATAACAG
AACAAGCTGTCTAAACACGATCAATACACC|GAAGCAGCTCAATGGTTTACCAGTATTTTC
TGTGGAAAGGTGCGCCGTTTTGAGTATACC|ATTGTTGTGCAATAATGCCAAACAAGCTGT
ATGCCAAACAAGCTGTCTAAGGAAGTCCGA|GGAAGAGAAGTGTGGCTTCGGCTCCCAGCA
CCAAACAAGCTGTCTAAACACGATCAATAC|TGCGAAGCAGCTCAATGGTTTACCAGTATT
TAGTGCACTCTCCACGACTCTGACCGGACG|CTGTCTAAACTGCATGTGGCGATAAAGAGC
GGGATACATCTTAGTGCACTCTCCACGACT|TGCCAAACAAGCTGTCTAAACTGCATGTGG
ATGTGGCGATAAAGAGCCTTTGCTGTCATC|CGCCTCAAGCGAGAAGTGGGATTAGTATAA
TCGTCTCTGGCCTGACCAGTGCACCATGGT|CGTTAACGCTGCCTGGTAGGGCTGCACTGC
TCGTTTCATGTACTCGGATGCGCTAACCGG|CAATAATGCCAAACAAGCTGTCTAACATTG
AAAACATTACAGAACCAGTGCAGGCGCCAG|CCGGTTAGGAATCACCTTTCGCATGGACGC
CAATAATGCCAAACAAGCTGTCTAAGCGTT|TAAAATGTGTTGTGCAATAATGCCAAACAA
CAAGCTGTCTAACATTGTCTAACGTGCCGA|GCCCAACTAGCACCCATAACTCGTTTGGGA
AAACTGCATGTGGCGATAAAGAGCCTTTGC|ATGGGTGCGCCTCAAGCGAGAAGTGGGATT
ACCCATAACTCGTTTGGGAGTTTATCGTTC|GTATACCGTTGACCTTTGTGCAATAATGCC
ATGCGAAGCAGCTCAATGGTTTACCAGTAT|GCTGTCTAAAACATTACAGAACCAGTGCAG
TCACCTTTCGCATGGACGCTAGATGCATTT|CAATAATGCCAAACAAGCTGTCTAATAAGC
CACGACTCTGACCGGACGCAGCTGACGACG|CATGTGGCGATAAAGAGCCTTTGCTGTCAT
GCTGCCTGGTAGGGCTGCACTGCAAATTTG|TAAACACGATCAATACACCAGCTTGAGCTC
CACGATCAATACACCAGCTTGAGCTCGTCT|TTTACCAGTATTTTCGTTACTGGTTTATAT
TAACGTGCCGAACACTTTGTGCAATAATGC|CTCGTTTGGGAGTTTATCGTTCAGGATAAT
AGCGATTGTAGCTTGTGCAATTTGTGCAAT|GCCCTATACAGGTGCCGTTGTGCAATAATG
TAATGCGAAGCAGCTCAATGGTTTACCAGT|AAGCTGTCTAAAACATTACAGAACCAGTGC
ATAATTGATCGCAGCCCGACCATGCTCGTA|GCTAGGGAAAACATAGTTGGCCAGGTAGAG
AGTCCGACTGGTAGCGTTCGTCTCTGGCCT|CCCAGCACCTCTCGTCTCGTTAACGCTGCC
ACCCGTAGCCTCATCTGTTTTGTGCAATAA|TGGATCTGGCGTCTACCCGCGCCAGATTGC
AAATGCCAAACAAGCTGTCTAAGACATGCG|GGGATACATCTTAGTGCACTCTCCACGACT
TTGTGCAATAATGCCAAACAAGCTGTCTAA|CGCCAGATTGCTCGTTAATGCCACCCAGAT
CAAACAAGCTGTCTAAACTGCATGTGGCGA|TTAATGCCACCCAGATGGGTGCGCCTCAAG
TGTCTTGTGCAATAATGCCAAACAAGCTGT|TCCGTTGTGCAATAATGCCAAACAAGCTGT
CCGGTTAGGAATCACCTTTCGCATGGACGC|GCTGTCTTGTGCAATAATGCCAAACAAGCT
AACAAGCTGTCTAAAATGTGTTGTGCAATA|AATGCCAAACAAGCTGTCTAAGACATGCGG
CAAGCTGTCTAATGCAATAATGCCAAACAA|CCAAACAAGCTGTCTAAAATGTGTTGTGCA
CCTTTCGCATGGACGCTAGATGCATTTAAG|TAATGCCAAACAAGCTGTCTAATAAGCGAT
ACCAGTATTTTCGTTACTGGTTTATATTAG|CAGTGCAGGCGCCAGTTTCGGAAGCTGCGA
TCGTATAGCTGTCGCGAAACCCTAGACGCG|GGAGGTTGTAGTTGCAACTGTGGAAAGGTG
ATGCCAAACAAGCTGTCTAAGACATGCGGC|GATACATCTTAGTGCACTCTCCACGACTCT
CTAATAAGCGATTGTAGCTTGTGCAATTTG|CTAATAGCCCTATACAGGTGCCGTTGTGCA
TGTCTAAGGAAGTCCGACTGGTAGCGTTCG|GGCTTCGGCTCCCAGCACCTCTCGTCTCGT
ACATCTTAGTGCACTCTCCACGACTCTGAC|AACAAGCTGTCTAAACTGCATGTGGCGATA
TCTTAGTGCACTCTCCACGACTCTGACCGG|AAGCTGTCTAAACTGCATGTGGCGATAAAG
TAATGCCAAACAAGCTGTCTAAAACATTAC|AAACAAGCTGTCTAAGCGTTCCGGTTAGGA
TAAGTTGTGCAATAATGCCAAACAAGCTGT|CGATTGTAGCTTGTGCAATTTGTGCAATAA
TTGTGCAATAATGCCAAACAAGCTGTCTAA|CAAACAAGCTGTCTAAAATGCCAAACAAGC
TCTAAAATGCCAAACAAGCTGTCTAAGACA|AAGGGGGATACATCTTAGTGCACTCTCCAC
TCGTTAACGCTGCCTGGTAGGGCTGCACTG|AAGCTGTCTAAACACGATCAATACACCAGC
TCAGGATAATGCGAAGCAGCTCAATGGTTT|CCAAACAAGCTGTCTAAAACATTACAGAAC
GATCTTACTTTTGTGCAATAATGCCAAACA|TGTACTCGGATGCGCTAACCGGAAGAGAAG
AAACAAGCTGTCTAATAAGCGATTGTAGCT|AAACAAGCTGTCTAATAGCCCTATACAGGT
TGCCAAACAAGCTGTCTAAAATGCCAAACA|AAACAAGCTGTCTAAAGGGGGATACATCTT
CCTTTGTGCAATAATGCCAAACAAGCTGTC|GCAATAATGCCAAACAAGCTGTCTAAGCGT
CCAAACAAGCTGTCTAAAATGTGTTGTGCA|TAAAATGCCAAACAAGCTGTCTAAGACATG
AGACGCGGCCCAACTAGCACCCATAACTCG|AAAGGTGCGCCGTTTTGAGTATACCGTTGA
GCAATAATGCCAAACAAGCTGTCTAAGGAA|CTAACCGGAAGAGAAGTGTGGCTTCGGCTC
TATACAGGTGCCGTTGTGCAATAATGCCAA|AATCTGTCCACTTTCGACCCGTAGCCTCAT
CCAAACAAGCTGTCTAATAAGCGATTGTAG|CCAAACAAGCTGTCTAATAGCCCTATACAG
ACAGAACCAGTGCAGGCGCCAGTTTCGGAA|GAATCACCTTTCGCATGGACGCTAGATGCA
CTTACTTTTGTGCAATAATGCCAAACAAGC|ACTCGGATGCGCTAACCGGAAGAGAAGTGT
TTCGGAAGCTGCGAACTGTTCGTCGCGGGT|AGATGCATTTAAGTTGTGCAATAATGCCAA
GCGATAAAGAGCCTTTGCTGTCATCCGCTA|CAAGCGAGAAGTGGGATTAGTATAACAGAG
CTGACGACGGCATAATTGATCGCAGCCCGA|TGCTGTCATCCGCTAGGGAAAACATAGTTG
GCAATAATGCCAAACAAGCTGTCTAATAGC|GGCATAATTGATCGCAGCCCGACCATGCTC
GCAATAATGCCAAACAAGCTGTCTTGTGCA|ATGCGGCGATAACGGTAGTTCCGTTGTGCA
GCTGTCTAAAATGTGTTGTGCAATAATGCC|CAAACAAGCTGTCTAAGACATGCGGCGATA
TTGCAACTGTGGAAAGGTGCGCCGTTTTGA|GGGTTTTATTGTTGTGCAATAATGCCAAAC
CCTCCACCAGCTATCACGGGAGATCTTACT|GGGACTAAGGCATTCGTTTCATGTACTCGG
AATGGTTTACCAGTATTTTCGTTACTGGTT|TACAGAACCAGTGCAGGCGCCAGTTTCGGA
GCTGTCTAATAGCCCTATACAGGTGCCGTT|CCCGACCATGCTCGTAATCTGTCCACTTTC
TGCGAAGCAGCTCAATGGTTTACCAGTATT|CTGTCTAAAACATTACAGAACCAGTGCAGG
GTGTGGCTTCGGCTCCCAGCACCTCTCGTC|TGCCGAACACTTTGTGCAATAATGCCAAAC
TCCGTTGTGCAATAATGCCAAACAAGCTGT|CTGACGACGGCATAATTGATCGCAGCCCGA
GATGCATTTAAGTTGTGCAATAATGCCAAA|CTAATAAGCGATTGTAGCTTGTGCAATTTG
AATGCCAAACAAGCTGTCTAATGCAATAAT|GCAATAATGCCAAACAAGCTGTCTAAAATG
GCATGTGGCGATAAAGAGCCTTTGCTGTCA|TGCGCCTCAAGCGAGAAGTGGGATTAGTAT
AAGGGGGATACATCTTAGTGCACTCTCCAC|ATAATGCCAAACAAGCTGTCTAAACTGCAT
TAGAATTGTGCAATAATGCCAAACAAGCTG|GCTGTCGCGAAACCCTAGACGCGGCCCAAC
GTTGACCTTTGTGCAATAATGCCAAACAAG|CTAATGCAATAATGCCAAACAAGCTGTCTA
ACTTTGTGCAATAATGCCAAACAAGCTGTC|TTATCGTTCAGGATAATGCGAAGCAGCTCA
GGTGTCACCGTTTGATAAGGACGGGACTAA|TGCAAATTTGCCGTCAAGCGCCGATTAGAA
GCTGTCTAAAATGCCAAACAAGCTGTCTAA|TCTAAAGGGGGATACATCTTAGTGCACTCT
AACTGCATGTGGCGATAAAGAGCCTTTGCT|TGGGTGCGCCTCAAGCGAGAAGTGGGATTA
TGCACCATGGTGTCACCGTTTGATAAGGAC|GGCTGCACTGCAAATTTGCCGTCAAGCGCC
GTTCAGGATAATGCGAAGCAGCTCAATGGT|TGCCAAACAAGCTGTCTAAAACATTACAGA
ACCAGTGCACCATGGTGTCACCGTTTGATA|GGTAGGGCTGCACTGCAAATTTGCCGTCAA
GATGCGCTAACCGGAAGAGAAGTGTGGCTT|GCTGTCTAACATTGTCTAACGTGCCGAACA
GTATAGCTGTCGCGAAACCCTAGACGCGGC|AGGTTGTAGTTGCAACTGTGGAAAGGTGCG
AAGTTGTGCAATAATGCCAAACAAGCTGTC|GATTGTAGCTTGTGCAATTTGTGCAATAAT
GTGCAATAATGCCAAACAAGCTGTCTAACA|CGAAACCCTAGACGCGGCCCAACTAGCACC
CCGTCAAGCGCCGATTAGAATTGTGCAATA|GTCTGAGGTCGTATAGCTGTCGCGAAACCC
ATAGCCCTATACAGGTGCCGTTGTGCAATA|TGCTCGTAATCTGTCCACTTTCGACCCGTA
TGCTCGTAATCTGTCCACTTTCGACCCGTA|AGGTAGAGAACGTTCACTGCAGATGGATCT
TGTCTAACGTGCCGAACACTTTGTGCAATA|ATAACTCGTTTGGGAGTTTATCGTTCAGGA
CAAACAAGCTGTCTAAAGGGGGATACATCT|CATCTGTTTTGTGCAATAATGCCAAACAAG
GGAGATCTTACTTTTGTGCAATAATGCCAA|TCATGTACTCGGATGCGCTAACCGGAAGAG
CTGGTTTATATTAGTGGAGGTTGTAGTTGC|TTCGGAAGCTGCGAACTGTTCGTCGCGGGT
TGATAAGGACGGGACTAAGGCATTCGTTTC|GTCAAGCGCCGATTAGAATTGTGCAATAAT
CTCCCAGCACCTCTCGTCTCGTTAACGCTG|TGTGCAATAATGCCAAACAAGCTGTCTAAA
ATCTTACTTTTGTGCAATAATGCCAAACAA|GTACTCGGATGCGCTAACCGGAAGAGAAGT
TCGTAATCTGTCCACTTTCGACCCGTAGCC|TAGAGAACGTTCACTGCAGATGGATCTGGC
TTTCATGTACTCGGATGCGCTAACCGGAAG|TAATGCCAAACAAGCTGTCTAACATTGTCT
ATTCGTTTCATGTACTCGGATGCGCTAACC|TGCAATAATGCCAAACAAGCTGTCTAACAT
AATACACCAGCTTGAGCTCGTCTGAGGTCG|GTATTTTCGTTACTGGTTTATATTAGTGGA
AAACAAGCTGTCTAACATTGTCTAACGTGC|GCGGCCCAACTAGCACCCATAACTCGTTTG
TCTCTGGCCTGACCAGTGCACCATGGTGTC|TAACGCTGCCTGGTAGGGCTGCACTGCAAA
CAGCTTGAGCTCGTCTGAGGTCGTATAGCT|CGTTACTGGTTTATATTAGTGGAGGTTGTA
TGTGCAATAATGCCAAACAAGCTGTCTAAA|GCCAGATTGCTCGTTAATGCCACCCAGATG
GGTTAGGAATCACCTTTCGCATGGACGCTA|TGTCTTGTGCAATAATGCCAAACAAGCTGT
TCCCAGCACCTCTCGTCTCGTTAACGCTGC|GTGCAATAATGCCAAACAAGCTGTCTAAAC
ATAACGGTAGTTCCGTTGTGCAATAATGCC|ACCGGACGCAGCTGACGACGGCATAATTGA
TTGAGTATACCGTTGACCTTTGTGCAATAA|AAACAAGCTGTCTAATGCAATAATGCCAAA
TTGTGCAATAATGCCAAACAAGCTGTCTAT|TGTAGCTTGTGCAATTTGTGCAATAATGCC
GCCAAACAAGCTGTCTAAAATGCCAAACAA|AACAAGCTGTCTAAAGGGGGATACATCTTA
ACGATCAATACACCAGCTTGAGCTCGTCTG|TTACCAGTATTTTCGTTACTGGTTTATATT
TGTAGTTGCAACTGTGGAAAGGTGCGCCGT|GTCGCGGGTTTTATTGTTGTGCAATAATGC
GACCCGTAGCCTCATCTGTTTTGTGCAATA|ATGGATCTGGCGTCTACCCGCGCCAGATTG
GTTAACGCTGCCTGGTAGGGCTGCACTGCA|GCTGTCTAAACACGATCAATACACCAGCTT
ATGCCAAACAAGCTGTCTAATAAGCGATTG|ATGCCAAACAAGCTGTCTAATAGCCCTATA
GGAAGCTGCGAACTGTTCGTCGCGGGTTTT|TGCATTTAAGTTGTGCAATAATGCCAAACA
TCATCTGTTTTGTGCAATAATGCCAAACAA|GTCTACCCGCGCCAGATTGCTCGTTAATGC
GGGCTGCACTGCAAATTTGCCGTCAAGCGC|AATACACCAGCTTGAGCTCGTCTGAGGTCG
ATTGATCGCAGCCCGACCATGCTCGTAATC|AGGGAAAACATAGTTGGCCAGGTAGAGAAC
GACCATGCTCGTAATCTGTCCACTTTCGAC|TGGCCAGGTAGAGAACGTTCACTGCAGATG
TCACGGGAGATCTTACTTTTGTGCAATAAT|TCGTTTCATGTACTCGGATGCGCTAACCGG
CAGGTGCCCTCCACCAGCTATCACGGGAGA|TAAGGACGGGACTAAGGCATTCGTTTCATG
GCTATCACGGGAGATCTTACTTTTGTGCAA|GCATTCGTTTCATGTACTCGGATGCGCTAA
TTAACGCTGCCTGGTAGGGCTGCACTGCAA|CTGTCTAAACACGATCAATACACCAGCTTG
AGAATTGTGCAATAATGCCAAACAAGCTGT|CTGTCGCGAAACCCTAGACGCGGCCCAACT
AAGACATGCGGCGATAACGGTAGTTCCGTT|CTCCACGACTCTGACCGGACGCAGCTGACG
CGTAGCCTCATCTGTTTTGTGCAATAATGC|ATCTGGCGTCTACCCGCGCCAGATTGCTCG
CGTTGTGCAATAATGCCAAACAAGCTGTCT|TTTCGACCCGTAGCCTCATCTGTTTTGTGC
GCTCAATGGTTTACCAGTATTTTCGTTACT|ACATTACAGAACCAGTGCAGGCGCCAGTTT
GACCTTTGTGCAATAATGCCAAACAAGCTG|ATGCAATAATGCCAAACAAGCTGTCTAAGC
TCATGTACTCGGATGCGCTAACCGGAAGAG|ATGCCAAACAAGCTGTCTAACATTGTCTAA
AATAATGCCAAACAAGCTGTCTAATAGCCC|CATAATTGATCGCAGCCCGACCATGCTCGT
TTTTCGTTACTGGTTTATATTAGTGGAGGT|GGCGCCAGTTTCGGAAGCTGCGAACTGTTC
TGTGCAATAATGCCAAACAAGCTGTCTAAT|TGTGCAATAATGCCAAACAAGCTGTCTAAT
ATGCCAAACAAGCTGTCTAAGCGTTCCGGT|TGTGTTGTGCAATAATGCCAAACAAGCTGT
TAAACACGATCAATACACCAGCTTGAGCTC|ATGGTTTACCAGTATTTTCGTTACTGGTTT
CACTGCAAATTTGCCGTCAAGCGCCGATTA|CCAGCTTGAGCTCGTCTGAGGTCGTATAGC
TTTCGCATGGACGCTAGATGCATTTAAGTT|ATGCCAAACAAGCTGTCTAATAAGCGATTG
TAAAGAGCCTTTGCTGTCATCCGCTAGGGA|CGAGAAGTGGGATTAGTATAACAGAGTCCC
GTGGAGGTTGTAGTTGCAACTGTGGAAAGG|AACTGTTCGTCGCGGGTTTTATTGTTGTGC
AACAAGCTGTCTAAAACATTACAGAACCAG|TGTCTAAGCGTTCCGGTTAGGAATCACCTT
ACCATGCTCGTAATCTGTCCACTTTCGACC|GGCCAGGTAGAGAACGTTCACTGCAGATGG
AATAATGCCAAACAAGCTGTCTAAGCGTTC|AAAATGTGTTGTGCAATAATGCCAAACAAG
TGGACGCTAGATGCATTTAAGTTGTGCAAT|ACAAGCTGTCTAATAAGCGATTGTAGCTTG
GCAAATTTGCCGTCAAGCGCCGATTAGAAT|CTTGAGCTCGTCTGAGGTCGTATAGCTGTC
AAGCTGTCTAATAGCCCTATACAGGTGCCG|AGCCCGACCATGCTCGTAATCTGTCCACTT
TGCCAAACAAGCTGTCTAAGACATGCGGCG|ATACATCTTAGTGCACTCTCCACGACTCTG
GGTGCGCCGTTTTGAGTATACCGTTGACCT|GCAATAATGCCAAACAAGCTGTCTAATGCA
GCTGCGAACTGTTCGTCGCGGGTTTTATTG|TTTAAGTTGTGCAATAATGCCAAACAAGCT
CTGTCGCGAAACCCTAGACGCGGCCCAACT|TAGTTGCAACTGTGGAAAGGTGCGCCGTTT
ACTGTTCGTCGCGGGTTTTATTGTTGTGCA|TGTGCAATAATGCCAAACAAGCTGTCTATT
TGGCCTGACCAGTGCACCATGGTGTCACCG|GCTGCCTGGTAGGGCTGCACTGCAAATTTG
AAATTTGCCGTCAAGCGCCGATTAGAATTG|TGAGCTCGTCTGAGGTCGTATAGCTGTCGC
CAAACAAGCTGTCTATTGTGCAATAATGCC|TTTGTGCAATAATGCCAAACAAGCTGTCTA
TCGCATGGACGCTAGATGCATTTAAGTTGT|GCCAAACAAGCTGTCTAATAAGCGATTGTA
TTGATAAGGACGGGACTAAGGCATTCGTTT|CGTCAAGCGCCGATTAGAATTGTGCAATAA
ACCCTAGACGCGGCCCAACTAGCACCCATA|TGTGGAAAGGTGCGCCGTTTTGAGTATACC
TAATGCCAAACAAGCTGTCTAAAATGCCAA|GCCAAACAAGCTGTCTAAAGGGGGATACAT
AGGTCGTATAGCTGTCGCGAAACCCTAGAC|AGTGGAGGTTGTAGTTGCAACTGTGGAAAG
GCCCTCCACCAGCTATCACGGGAGATCTTA|ACGGGACTAAGGCATTCGTTTCATGTACTC
GCCAAACAAGCTGTCTAAGACATGCGGCGA|TACATCTTAGTGCACTCTCCACGACTCTGA
CTTTGCTGTCATCCGCTAGGGAAAACATAG|GGGATTAGTATAACAGAGTCCCCAGAGAGT
GCCAAACAAGCTGTCTAAGGAAGTCCGACT|AAGAGAAGTGTGGCTTCGGCTCCCAGCACC
TGCAATAATGCCAAACAAGCTGTCTAAGCG|TCTAAAATGTGTTGTGCAATAATGCCAAAC
CAAGCTGTCTATTGTGCAATAATGCCAAAC|TGCAATAATGCCAAACAAGCTGTCTAAAAT
TGCAATAATGCCAAACAAGCTGTCTTGTGC|CATGCGGCGATAACGGTAGTTCCGTTGTGC
AAACAAGCTGTCTAAGACATGCGGCGATAA|ATCTTAGTGCACTCTCCACGACTCTGACCG
GCCAAACAAGCTGTCTAAAATGTGTTGTGC|CTAAAATGCCAAACAAGCTGTCTAAGACAT
CGGACGCAGCTGACGACGGCATAATTGATC|AAGAGCCTTTGCTGTCATCCGCTAGGGAAA
TGCAATAATGCCAAACAAGCTGTCTAATAG|CGGCATAATTGATCGCAGCCCGACCATGCT
GTAATCTGTCCACTTTCGACCCGTAGCCTC|GAGAACGTTCACTGCAGATGGATCTGGCGT
TTTTGAGTATACCGTTGACCTTTGTGCAAT|CCAAACAAGCTGTCTAATGCAATAATGCCA
CGGGTTTTATTGTTGTGCAATAATGCCAAA|GCCAAACAAGCTGTCTATTGTGCAATAATG
ACAGGTGCCGTTGTGCAATAATGCCAAACA|CTGTCCACTTTCGACCCGTAGCCTCATCTG
AAGCTGTCTAATAAGCGATTGTAGCTTGTG|AAGCTGTCTAATAGCCCTATACAGGTGCCG
ATAATGCCAAACAAGCTGTCTAAACTGCAT|TTGCTCGTTAATGCCACCCAGATGGGTGCG
CAAACAAGCTGTCTTGTGCAATAATGCCAA|AACGGTAGTTCCGTTGTGCAATAATGCCAA
GTGCAATAATGCCAAACAAGCTGTCTAAAC|GTTCAGGATAATGCGAAGCAGCTCAATGGT
TATATTAGTGGAGGTTGTAGTTGCAACTGT|AGCTGCGAACTGTTCGTCGCGGGTTTTATT
AAGCTGTCTAAGACATGCGGCGATAACGGT|TAGTGCACTCTCCACGACTCTGACCGGACG
TGAGGTCGTATAGCTGTCGCGAAACCCTAG|TTAGTGGAGGTTGTAGTTGCAACTGTGGAA
GGCTTCGGCTCCCAGCACCTCTCGTCTCGT|GAACACTTTGTGCAATAATGCCAAACAAGC
GCTGTCTTGTGCAATAATGCCAAACAAGCT|GTTCCGTTGTGCAATAATGCCAAACAAGCT
TAGTTCCGTTGTGCAATAATGCCAAACAAG|GCAGCTGACGACGGCATAATTGATCGCAGC
CAAACAAGCTGTCTAAGACATGCGGCGATA|CATCTTAGTGCACTCTCCACGACTCTGACC
TTTGCCGTCAAGCGCCGATTAGAATTGTGC|GCTCGTCTGAGGTCGTATAGCTGTCGCGAA
CGATCAATACACCAGCTTGAGCTCGTCTGA|TACCAGTATTTTCGTTACTGGTTTATATTA
GACTGGTAGCGTTCGTCTCTGGCCTGACCA|CACCTCTCGTCTCGTTAACGCTGCCTGGTA
CAAACAAGCTGTCTAAGCGTTCCGGTTAGG|TTGTGCAATAATGCCAAACAAGCTGTCTTG
TACCAGTATTTTCGTTACTGGTTTATATTA|CCAGTGCAGGCGCCAGTTTCGGAAGCTGCG
GCCGTTGTGCAATAATGCCAAACAAGCTGT|ACTTTCGACCCGTAGCCTCATCTGTTTTGT
ACGGGAGATCTTACTTTTGTGCAATAATGC|GTTTCATGTACTCGGATGCGCTAACCGGAA
GGCATAATTGATCGCAGCCCGACCATGCTC|TCCGCTAGGGAAAACATAGTTGGCCAGGTA
ACAAGCTGTCTTGTGCAATAATGCCAAACA|GGTAGTTCCGTTGTGCAATAATGCCAAACA
GGTTTATATTAGTGGAGGTTGTAGTTGCAA|CGGAAGCTGCGAACTGTTCGTCGCGGGTTT
CCAAACAAGCTGTCTAAGGAAGTCCGACTG|AGAGAAGTGTGGCTTCGGCTCCCAGCACCT
TTGACCTTTGTGCAATAATGCCAAACAAGC|TAATGCAATAATGCCAAACAAGCTGTCTAA
AACAAGCTGTCTAAGGAAGTCCGACTGGTA|GAAGTGTGGCTTCGGCTCCCAGCACCTCTC
GTCTAAAACATTACAGAACCAGTGCAGGCG|CGTTCCGGTTAGGAATCACCTTTCGCATGG
GGATGCGCTAACCGGAAGAGAAGTGTGGCT|AGCTGTCTAACATTGTCTAACGTGCCGAAC
AAACAAGCTGTCTAAACACGATCAATACAC|CGAAGCAGCTCAATGGTTTACCAGTATTTT
TGCAATAATGCCAAACAAGCTGTCTAAGGA|GCTAACCGGAAGAGAAGTGTGGCTTCGGCT
GTCTATTGTGCAATAATGCCAAACAAGCTG|AATGCCAAACAAGCTGTCTAAAATGCCAAA
TGTGCAATAATGCCAAACAAGCTGTCTAAG|GCGCTAACCGGAAGAGAAGTGTGGCTTCGG
CAGTGCACCATGGTGTCACCGTTTGATAAG|TAGGGCTGCACTGCAAATTTGCCGTCAAGC
ACACGATCAATACACCAGCTTGAGCTCGTC|GTTTACCAGTATTTTCGTTACTGGTTTATA
CAAACAAGCTGTCTAAAACATTACAGAACC|GCTGTCTAAGCGTTCCGGTTAGGAATCACC
TCAAGCGCCGATTAGAATTGTGCAATAATG|TGAGGTCGTATAGCTGTCGCGAAACCCTAG
AATAATGCCAAACAAGCTGTCTAATGCAAT|TGTGCAATAATGCCAAACAAGCTGTCTAAA
TAACTCGTTTGGGAGTTTATCGTTCAGGAT|CCGTTGACCTTTGTGCAATAATGCCAAACA
CCAAACAAGCTGTCTTGTGCAATAATGCCA|TAACGGTAGTTCCGTTGTGCAATAATGCCA
ACTGCAAATTTGCCGTCAAGCGCCGATTAG|CAGCTTGAGCTCGTCTGAGGTCGTATAGCT
TAGGAATCACCTTTCGCATGGACGCTAGAT|CTTGTGCAATAATGCCAAACAAGCTGTCTA
CAATAATGCCAAACAAGCTGTCTATTGTGC|CTTGTGCAATTTGTGCAATAATGCCAAACA
ACAAGCTGTCTAATAAGCGATTGTAGCTTG|ACAAGCTGTCTAATAGCCCTATACAGGTGC
TGCCAAACAAGCTGTCTAAGGAAGTCCGAC|GAAGAGAAGTGTGGCTTCGGCTCCCAGCAC
AGCTCGTCTGAGGTCGTATAGCTGTCGCGA|GGTTTATATTAGTGGAGGTTGTAGTTGCAA
GTTCGTCGCGGGTTTTATTGTTGTGCAATA|GCAATAATGCCAAACAAGCTGTCTATTGTG
ACAAGCTGTCTATTGTGCAATAATGCCAAA|GTGCAATAATGCCAAACAAGCTGTCTAAAA
AATTGTGCAATAATGCCAAACAAGCTGTCT|GTCGCGAAACCCTAGACGCGGCCCAACTAG
TCTAACGTGCCGAACACTTTGTGCAATAAT|AACTCGTTTGGGAGTTTATCGTTCAGGATA
CGCGAAACCCTAGACGCGGCCCAACTAGCA|TGCAACTGTGGAAAGGTGCGCCGTTTTGAG
TGCCAAACAAGCTGTCTAATAGCCCTATAC|TTGATCGCAGCCCGACCATGCTCGTAATCT
AGCGCCGATTAGAATTGTGCAATAATGCCA|GGTCGTATAGCTGTCGCGAAACCCTAGACG
TTTATATTAGTGGAGGTTGTAGTTGCAACT|GAAGCTGCGAACTGTTCGTCGCGGGTTTTA
CAGCCCGACCATGCTCGTAATCTGTCCACT|CATAGTTGGCCAGGTAGAGAACGTTCACTG
GCAACTGTGGAAAGGTGCGCCGTTTTGAGT|GTTTTATTGTTGTGCAATAATGCCAAACAA
CCAAACAAGCTGTCTAAACTGCATGTGGCG|GTTAATGCCACCCAGATGGGTGCGCCTCAA
GACCAGTGCACCATGGTGTCACCGTTTGAT|TGGTAGGGCTGCACTGCAAATTTGCCGTCA
ACAAGCTGTCTAAAGGGGGATACATCTTAG|CTGTTTTGTGCAATAATGCCAAACAAGCTG
CTGTTTTGTGCAATAATGCCAAACAAGCTG|ACCCGCGCCAGATTGCTCGTTAATGCCACC
ATAATGCGAAGCAGCTCAATGGTTTACCAG|CAAGCTGTCTAAAACATTACAGAACCAGTG
ACAAGCTGTCTAACATTGTCTAACGTGCCG|GGCCCAACTAGCACCCATAACTCGTTTGGG
CTGGTAGCGTTCGTCTCTGGCCTGACCAGT|CCTCTCGTCTCGTTAACGCTGCCTGGTAGG
CGTTTCATGTACTCGGATGCGCTAACCGGA|AATAATGCCAAACAAGCTGTCTAACATTGT
TTATATTAGTGGAGGTTGTAGTTGCAACTG|AAGCTGCGAACTGTTCGTCGCGGGTTTTAT
TCTAATAGCCCTATACAGGTGCCGTTGTGC|ACCATGCTCGTAATCTGTCCACTTTCGACC
CCAGTTTCGGAAGCTGCGAACTGTTCGTCG|ACGCTAGATGCATTTAAGTTGTGCAATAAT
ACTCGTTTGGGAGTTTATCGTTCAGGATAA|GTTGACCTTTGTGCAATAATGCCAAACAAG
CAAGCTGTCTAATAAGCGATTGTAGCTTGT|CAAGCTGTCTAATAGCCCTATACAGGTGCC
AGCCCGACCATGCTCGTAATCTGTCCACTT|ATAGTTGGCCAGGTAGAGAACGTTCACTGC
ATTTGTGCAATAATGCCAAACAAGCTGTCT|GTGCAATAATGCCAAACAAGCTGTCTAAAG
CTAGACGCGGCCCAACTAGCACCCATAACT|GGAAAGGTGCGCCGTTTTGAGTATACCGTT
GCTGTCTAAACACGATCAATACACCAGCTT|AGCTCAATGGTTTACCAGTATTTTCGTTAC
CTCAATGGTTTACCAGTATTTTCGTTACTG|CATTACAGAACCAGTGCAGGCGCCAGTTTC
TTGCCGTCAAGCGCCGATTAGAATTGTGCA|CTCGTCTGAGGTCGTATAGCTGTCGCGAAA
AAACAAGCTGTCTAAAATGCCAAACAAGCT|AAGCTGTCTAAAGGGGGATACATCTTAGTG
GCTGTCTATTGTGCAATAATGCCAAACAAG|AATAATGCCAAACAAGCTGTCTAAAATGCC
GAACTGTTCGTCGCGGGTTTTATTGTTGTG|GTTGTGCAATAATGCCAAACAAGCTGTCTA
CTAAGCGTTCCGGTTAGGAATCACCTTTCG|GCCAAACAAGCTGTCTTGTGCAATAATGCC
CGCTAACCGGAAGAGAAGTGTGGCTTCGGC|TCTAACATTGTCTAACGTGCCGAACACTTT
ACGGTAGTTCCGTTGTGCAATAATGCCAAA|GGACGCAGCTGACGACGGCATAATTGATCG
CAGTGCAGGCGCCAGTTTCGGAAGCTGCGA|CTTTCGCATGGACGCTAGATGCATTTAAGT
AATAATGCCAAACAAGCTGTCTAAACACGA|AGGATAATGCGAAGCAGCTCAATGGTTTAC
ATGCCAAACAAGCTGTCTAAAACATTACAG|ACAAGCTGTCTAAGCGTTCCGGTTAGGAAT
ATTGTGCAATAATGCCAAACAAGCTGTCTA|CCAAACAAGCTGTCTAAAATGCCAAACAAG
CAGGATAATGCGAAGCAGCTCAATGGTTTA|CAAACAAGCTGTCTAAAACATTACAGAACC
AGTTTCGGAAGCTGCGAACTGTTCGTCGCG|GCTAGATGCATTTAAGTTGTGCAATAATGC
GTTGTGCAATAATGCCAAACAAGCTGTCTT|AAGACATGCGGCGATAACGGTAGTTCCGTT
AAAGGTGCGCCGTTTTGAGTATACCGTTGA|TGTGCAATAATGCCAAACAAGCTGTCTAAT
CATAGTTGGCCAGGTAGAGAACGTTCACTG|AGAGTTGGTTTGTCGCGTAAGGCCAACTCA
ATAAGGACGGGACTAAGGCATTCGTTTCAT|CAAGCGCCGATTAGAATTGTGCAATAATGC
AATAATGCCAAACAAGCTGTCTATTGTGCA|TTGTGCAATTTGTGCAATAATGCCAAACAA
CCAAACAAGCTGTCTAAAACATTACAGAAC|AGCTGTCTAAGCGTTCCGGTTAGGAATCAC
GAGCTCGTCTGAGGTCGTATAGCTGTCGCG|TGGTTTATATTAGTGGAGGTTGTAGTTGCA
ATGCCAAACAAGCTGTCTAAAATGCCAAAC|CAAACAAGCTGTCTAAAGGGGGATACATCT
ATGCATTTAAGTTGTGCAATAATGCCAAAC|TAATAAGCGATTGTAGCTTGTGCAATTTGT
CCCAGCACCTCTCGTCTCGTTAACGCTGCC|TGCAATAATGCCAAACAAGCTGTCTAAACA
CGCATGGACGCTAGATGCATTTAAGTTGTG|CCAAACAAGCTGTCTAATAAGCGATTGTAG
TTGATCGCAGCCCGACCATGCTCGTAATCT|GGGAAAACATAGTTGGCCAGGTAGAGAACG
TGTGCAATAATGCCAAACAAGCTGTCTAAT|TCTATTGTGCAATAATGCCAAACAAGCTGT
TAATGCCAAACAAGCTGTCTAAACTGCATG|TGCTCGTTAATGCCACCCAGATGGGTGCGC
AGCTGACGACGGCATAATTGATCGCAGCCC|TTTGCTGTCATCCGCTAGGGAAAACATAGT
CAAACAAGCTGTCTAAGGAAGTCCGACTGG|GAGAAGTGTGGCTTCGGCTCCCAGCACCTC
GACGCGGCCCAACTAGCACCCATAACTCGT|AAGGTGCGCCGTTTTGAGTATACCGTTGAC
AAAACATAGTTGGCCAGGTAGAGAACGTTC|CCAGAGAGTTGGTTTGTCGCGTAAGGCCAA
CTTTCGCATGGACGCTAGATGCATTTAAGT|AATGCCAAACAAGCTGTCTAATAAGCGATT
ATGGTGTCACCGTTTGATAAGGACGGGACT|ACTGCAAATTTGCCGTCAAGCGCCGATTAG
GCAATAATGCCAAACAAGCTGTCTAATGCA|ATTGTGCAATAATGCCAAACAAGCTGTCTA
TGCCCTCCACCAGCTATCACGGGAGATCTT|GACGGGACTAAGGCATTCGTTTCATGTACT
CATGGTGTCACCGTTTGATAAGGACGGGAC|CACTGCAAATTTGCCGTCAAGCGCCGATTA
AACAAGCTGTCTAATGCAATAATGCCAAAC|TGCCAAACAAGCTGTCTAAAATGTGTTGTG
AAGCTGCGAACTGTTCGTCGCGGGTTTTAT|CATTTAAGTTGTGCAATAATGCCAAACAAG
TTAGTGCACTCTCCACGACTCTGACCGGAC|GCTGTCTAAACTGCATGTGGCGATAAAGAG
TCCGACTGGTAGCGTTCGTCTCTGGCCTGA|CAGCACCTCTCGTCTCGTTAACGCTGCCTG
GGCATTCGTTTCATGTACTCGGATGCGCTA|TTGTGCAATAATGCCAAACAAGCTGTCTAA
CTCGTTAACGCTGCCTGGTAGGGCTGCACT|CAAGCTGTCTAAACACGATCAATACACCAG
CTTTGTGCAATAATGCCAAACAAGCTGTCT|TATCGTTCAGGATAATGCGAAGCAGCTCAA
AAGCTGTCTAAACACGATCAATACACCAGC|GCAGCTCAATGGTTTACCAGTATTTTCGTT
CTTTTGTGCAATAATGCCAAACAAGCTGTC|GGATGCGCTAACCGGAAGAGAAGTGTGGCT
ATAATGCCAAACAAGCTGTCTAATAGCCCT|ATAATTGATCGCAGCCCGACCATGCTCGTA
GTTTATCGTTCAGGATAATGCGAAGCAGCT|GCAATAATGCCAAACAAGCTGTCTAAAACA
TAGGGAAAACATAGTTGGCCAGGTAGAGAA|AGTCCCCAGAGAGTTGGTTTGTCGCGTAAG
GCACTCTCCACGACTCTGACCGGACGCAGC|CTAAACTGCATGTGGCGATAAAGAGCCTTT
AAACAAGCTGTCTTGTGCAATAATGCCAAA|ACGGTAGTTCCGTTGTGCAATAATGCCAAA
AACAAGCTGTCTAATAAGCGATTGTAGCTT|AACAAGCTGTCTAATAGCCCTATACAGGTG
CCGTTTGATAAGGACGGGACTAAGGCATTC|TTGCCGTCAAGCGCCGATTAGAATTGTGCA
TGCCAAACAAGCTGTCTAAAATGTGTTGTG|TCTAAAATGCCAAACAAGCTGTCTAAGACA
GCGATAACGGTAGTTCCGTTGTGCAATAAT|CTGACCGGACGCAGCTGACGACGGCATAAT
AATGCGAAGCAGCTCAATGGTTTACCAGTA|AGCTGTCTAAAACATTACAGAACCAGTGCA
CCAAACAAGCTGTCTAAAATGCCAAACAAG|ACAAGCTGTCTAAAGGGGGATACATCTTAG
ACTTTTGTGCAATAATGCCAAACAAGCTGT|CGGATGCGCTAACCGGAAGAGAAGTGTGGC
GGAATCACCTTTCGCATGGACGCTAGATGC|TGTGCAATAATGCCAAACAAGCTGTCTAAT
TCGGATGCGCTAACCGGAAGAGAAGTGTGG|CAAGCTGTCTAACATTGTCTAACGTGCCGA
ATGCCAAACAAGCTGTCTAACATTGTCTAA|TAGACGCGGCCCAACTAGCACCCATAACTC
GCCTCATCTGTTTTGTGCAATAATGCCAAA|GGCGTCTACCCGCGCCAGATTGCTCGTTAA
TGCAATAATGCCAAACAAGCTGTCTAAACT|CAGATTGCTCGTTAATGCCACCCAGATGGG
TGTAGCTTGTGCAATTTGTGCAATAATGCC|TACAGGTGCCGTTGTGCAATAATGCCAAAC
GCAATAATGCCAAACAAGCTGTCTAAACTG|AGATTGCTCGTTAATGCCACCCAGATGGGT
AACCAGTGCAGGCGCCAGTTTCGGAAGCTG|CACCTTTCGCATGGACGCTAGATGCATTTA
CGGGAGATCTTACTTTTGTGCAATAATGCC|TTTCATGTACTCGGATGCGCTAACCGGAAG
ACCAGTGCAGGCGCCAGTTTCGGAAGCTGC|ACCTTTCGCATGGACGCTAGATGCATTTAA
TTCGGCTCCCAGCACCTCTCGTCTCGTTAA|CACTTTGTGCAATAATGCCAAACAAGCTGT
AGATCTTACTTTTGTGCAATAATGCCAAAC|ATGTACTCGGATGCGCTAACCGGAAGAGAA
TGTGCAATAATGCCAAACAAGCTGTCTAAT|GACGGCATAATTGATCGCAGCCCGACCATG
CCAAACAAGCTGTCTAAGCGTTCCGGTTAG|GTTGTGCAATAATGCCAAACAAGCTGTCTT
TCCGGTTAGGAATCACCTTTCGCATGGACG|AGCTGTCTTGTGCAATAATGCCAAACAAGC
CACCCATAACTCGTTTGGGAGTTTATCGTT|AGTATACCGTTGACCTTTGTGCAATAATGC
TCGCAGCCCGACCATGCTCGTAATCTGTCC|AAACATAGTTGGCCAGGTAGAGAACGTTCA
CTGTCCACTTTCGACCCGTAGCCTCATCTG|CGTTCACTGCAGATGGATCTGGCGTCTACC
TTACAGAACCAGTGCAGGCGCCAGTTTCGG|AGGAATCACCTTTCGCATGGACGCTAGATG
GGTTTTATTGTTGTGCAATAATGCCAAACA|CAAACAAGCTGTCTATTGTGCAATAATGCC
TTTGTGCAATAATGCCAAACAAGCTGTCTA|ATCGTTCAGGATAATGCGAAGCAGCTCAAT
GTCTAAACACGATCAATACACCAGCTTGAG|TCAATGGTTTACCAGTATTTTCGTTACTGG
CAAGCTGTCTAAGACATGCGGCGATAACGG|TTAGTGCACTCTCCACGACTCTGACCGGAC
CTGTCTAAAACATTACAGAACCAGTGCAGG|AGCGTTCCGGTTAGGAATCACCTTTCGCAT
CATCTGTTTTGTGCAATAATGCCAAACAAG|TCTACCCGCGCCAGATTGCTCGTTAATGCC
ACCGTTTGATAAGGACGGGACTAAGGCATT|TTTGCCGTCAAGCGCCGATTAGAATTGTGC
ATAGTTGGCCAGGTAGAGAACGTTCACTGC|GAGTTGGTTTGTCGCGTAAGGCCAACTCAT
CTCGGATGCGCTAACCGGAAGAGAAGTGTG|ACAAGCTGTCTAACATTGTCTAACGTGCCG
ATTAGTGGAGGTTGTAGTTGCAACTGTGGA|TGCGAACTGTTCGTCGCGGGTTTTATTGTT
GTTGTGCAATAATGCCAAACAAGCTGTCTA|ACGACGGCATAATTGATCGCAGCCCGACCA
AATGCCAAACAAGCTGTCTAATAGCCCTAT|AATTGATCGCAGCCCGACCATGCTCGTAAT
ATAATGCCAAACAAGCTGTCTTGTGCAATA|CGGCGATAACGGTAGTTCCGTTGTGCAATA
GCGAACTGTTCGTCGCGGGTTTTATTGTTG|AAGTTGTGCAATAATGCCAAACAAGCTGTC
TAAACTGCATGTGGCGATAAAGAGCCTTTG|GATGGGTGCGCCTCAAGCGAGAAGTGGGAT
ATTACAGAACCAGTGCAGGCGCCAGTTTCG|TAGGAATCACCTTTCGCATGGACGCTAGAT
TCCACGACTCTGACCGGACGCAGCTGACGA|TGCATGTGGCGATAAAGAGCCTTTGCTGTC
TTGTGCAATAATGCCAAACAAGCTGTCTAA|TTGTGCAATAATGCCAAACAAGCTGTCTAA
AGCTGTCTAAACACGATCAATACACCAGCT|CAGCTCAATGGTTTACCAGTATTTTCGTTA
AGCTGTCTAATAAGCGATTGTAGCTTGTGC|AGCTGTCTAATAGCCCTATACAGGTGCCGT
AGCTGTCTAAAATGCCAAACAAGCTGTCTA|GTCTAAAGGGGGATACATCTTAGTGCACTC
CATCCGCTAGGGAAAACATAGTTGGCCAGG|ATAACAGAGTCCCCAGAGAGTTGGTTTGTC
TCATCCGCTAGGGAAAACATAGTTGGCCAG|TATAACAGAGTCCCCAGAGAGTTGGTTTGT
CGAAACCCTAGACGCGGCCCAACTAGCACC|CAACTGTGGAAAGGTGCGCCGTTTTGAGTA
TACCGTTGACCTTTGTGCAATAATGCCAAA|CTGTCTAATGCAATAATGCCAAACAAGCTG
GCTGTCTAACATTGTCTAACGTGCCGAACA|CAACTAGCACCCATAACTCGTTTGGGAGTT
CAATAATGCCAAACAAGCTGTCTAAAACAT|GCCAAACAAGCTGTCTAAGCGTTCCGGTTA
ATGCCAAACAAGCTGTCTAAAGGGGGATAC|GCCTCATCTGTTTTGTGCAATAATGCCAAA
CACCATGGTGTCACCGTTTGATAAGGACGG|CTGCACTGCAAATTTGCCGTCAAGCGCCGA
CCTCATCTGTTTTGTGCAATAATGCCAAAC|GCGTCTACCCGCGCCAGATTGCTCGTTAAT
AACAAGCTGTCTAAAGGGGGATACATCTTA|TCTGTTTTGTGCAATAATGCCAAACAAGCT
TGTGCAATAATGCCAAACAAGCTGTCTTGT|GACATGCGGCGATAACGGTAGTTCCGTTGT
GATTAGAATTGTGCAATAATGCCAAACAAG|ATAGCTGTCGCGAAACCCTAGACGCGGCCC
AACATTGTCTAACGTGCCGAACACTTTGTG|CACCCATAACTCGTTTGGGAGTTTATCGTT
TACTTTTGTGCAATAATGCCAAACAAGCTG|TCGGATGCGCTAACCGGAAGAGAAGTGTGG
CCTTTGCTGTCATCCGCTAGGGAAAACATA|TGGGATTAGTATAACAGAGTCCCCAGAGAG
GTCTCGTTAACGCTGCCTGGTAGGGCTGCA|AACAAGCTGTCTAAACACGATCAATACACC
CGTTAACGCTGCCTGGTAGGGCTGCACTGC|AGCTGTCTAAACACGATCAATACACCAGCT
CAGCTGACGACGGCATAATTGATCGCAGCC|CTTTGCTGTCATCCGCTAGGGAAAACATAG
ATAATGCCAAACAAGCTGTCTAATAAGCGA|ATAATGCCAAACAAGCTGTCTAATAGCCCT
CAATAATGCCAAACAAGCTGTCTTGTGCAA|TGCGGCGATAACGGTAGTTCCGTTGTGCAA
CGTTGACCTTTGTGCAATAATGCCAAACAA|TCTAATGCAATAATGCCAAACAAGCTGTCT
AACATAGTTGGCCAGGTAGAGAACGTTCAC|AGAGAGTTGGTTTGTCGCGTAAGGCCAACT
ATAATGCCAAACAAGCTGTCTAACATTGTC|CCCTAGACGCGGCCCAACTAGCACCCATAA
AGCTGTCTAAAGGGGGATACATCTTAGTGC|TTTTGTGCAATAATGCCAAACAAGCTGTCT
ATTAGAATTGTGCAATAATGCCAAACAAGC|TAGCTGTCGCGAAACCCTAGACGCGGCCCA
TGTCTAAAATGCCAAACAAGCTGTCTAAGA|TAAAGGGGGATACATCTTAGTGCACTCTCC
TAATAAGCGATTGTAGCTTGTGCAATTTGT|TAATAGCCCTATACAGGTGCCGTTGTGCAA
TCTAAAATGTGTTGTGCAATAATGCCAAAC|CAAGCTGTCTAAGACATGCGGCGATAACGG
TGCCGTCAAGCGCCGATTAGAATTGTGCAA|TCGTCTGAGGTCGTATAGCTGTCGCGAAAC
CGTAATCTGTCCACTTTCGACCCGTAGCCT|AGAGAACGTTCACTGCAGATGGATCTGGCG
CCGTTTTGAGTATACCGTTGACCTTTGTGC|ATGCCAAACAAGCTGTCTAATGCAATAATG
GCCAAACAAGCTGTCTAAACACGATCAATA|ATGCGAAGCAGCTCAATGGTTTACCAGTAT
TAAGCGATTGTAGCTTGTGCAATTTGTGCA|TAGCCCTATACAGGTGCCGTTGTGCAATAA
GCTGTCATCCGCTAGGGAAAACATAGTTGG|TTAGTATAACAGAGTCCCCAGAGAGTTGGT
CAGGCGCCAGTTTCGGAAGCTGCGAACTGT|GCATGGACGCTAGATGCATTTAAGTTGTGC
GCAGCTGACGACGGCATAATTGATCGCAGC|CCTTTGCTGTCATCCGCTAGGGAAAACATA
TATTGTTGTGCAATAATGCCAAACAAGCTG|AAGCTGTCTATTGTGCAATAATGCCAAACA
AGCTTGTGCAATTTGTGCAATAATGCCAAA|AGGTGCCGTTGTGCAATAATGCCAAACAAG
TGCATTTAAGTTGTGCAATAATGCCAAACA|AATAAGCGATTGTAGCTTGTGCAATTTGTG
GCAATAATGCCAAACAAGCTGTCTATTGTG|GCTTGTGCAATTTGTGCAATAATGCCAAAC
TTACTTTTGTGCAATAATGCCAAACAAGCT|CTCGGATGCGCTAACCGGAAGAGAAGTGTG
TGCAATAATGCCAAACAAGCTGTCTAACAT|GAAACCCTAGACGCGGCCCAACTAGCACCC
CCGCTAGGGAAAACATAGTTGGCCAGGTAG|ACAGAGTCCCCAGAGAGTTGGTTTGTCGCG
TAATAGCCCTATACAGGTGCCGTTGTGCAA|CATGCTCGTAATCTGTCCACTTTCGACCCG
CAAGCTGTCTAAGCGTTCCGGTTAGGAATC|GCAATAATGCCAAACAAGCTGTCTTGTGCA
CCATGGTGTCACCGTTTGATAAGGACGGGA|GCACTGCAAATTTGCCGTCAAGCGCCGATT
GGTTTACCAGTATTTTCGTTACTGGTTTAT|AGAACCAGTGCAGGCGCCAGTTTCGGAAGC
ACAAGCTGTCTAATGCAATAATGCCAAACA|GCCAAACAAGCTGTCTAAAATGTGTTGTGC
AGCTGTCGCGAAACCCTAGACGCGGCCCAA|TGTAGTTGCAACTGTGGAAAGGTGCGCCGT
CAATAATGCCAAACAAGCTGTCTAAAATGT|AAGCTGTCTAAAATGCCAAACAAGCTGTCT
AATAATGCCAAACAAGCTGTCTAAAACATT|CCAAACAAGCTGTCTAAGCGTTCCGGTTAG
GGGGATACATCTTAGTGCACTCTCCACGAC|ATGCCAAACAAGCTGTCTAAACTGCATGTG
ATAACTCGTTTGGGAGTTTATCGTTCAGGA|ACCGTTGACCTTTGTGCAATAATGCCAAAC
CTCCACCAGCTATCACGGGAGATCTTACTT|GGACTAAGGCATTCGTTTCATGTACTCGGA
ATCACCTTTCGCATGGACGCTAGATGCATT|GCAATAATGCCAAACAAGCTGTCTAATAAG
AAGTCCGACTGGTAGCGTTCGTCTCTGGCC|TCCCAGCACCTCTCGTCTCGTTAACGCTGC
CAATAATGCCAAACAAGCTGTCTAATGCAA|TTGTGCAATAATGCCAAACAAGCTGTCTAA
ATACACCAGCTTGAGCTCGTCTGAGGTCGT|TATTTTCGTTACTGGTTTATATTAGTGGAG
GGTAGGGCTGCACTGCAAATTTGCCGTCAA|GATCAATACACCAGCTTGAGCTCGTCTGAG
CTGTGGAAAGGTGCGCCGTTTTGAGTATAC|TATTGTTGTGCAATAATGCCAAACAAGCTG
TCGTTCAGGATAATGCGAAGCAGCTCAATG|AATGCCAAACAAGCTGTCTAAAACATTACA
GTAGCCTCATCTGTTTTGTGCAATAATGCC|TCTGGCGTCTACCCGCGCCAGATTGCTCGT
CTGTCTATTGTGCAATAATGCCAAACAAGC|ATAATGCCAAACAAGCTGTCTAAAATGCCA
CTAAGACATGCGGCGATAACGGTAGTTCCG|CTCTCCACGACTCTGACCGGACGCAGCTGA
TTTAAGTTGTGCAATAATGCCAAACAAGCT|AGCGATTGTAGCTTGTGCAATTTGTGCAAT
CCGAACACTTTGTGCAATAATGCCAAACAA|GGGAGTTTATCGTTCAGGATAATGCGAAGC
TTAGGAATCACCTTTCGCATGGACGCTAGA|TCTTGTGCAATAATGCCAAACAAGCTGTCT
CCCGACCATGCTCGTAATCTGTCCACTTTC|AGTTGGCCAGGTAGAGAACGTTCACTGCAG
AGCGTTCCGGTTAGGAATCACCTTTCGCAT|AAACAAGCTGTCTTGTGCAATAATGCCAAA
CCTCTCGTCTCGTTAACGCTGCCTGGTAGG|ATGCCAAACAAGCTGTCTAAACACGATCAA
ACAAGCTGTCTAATAGCCCTATACAGGTGC|GCAGCCCGACCATGCTCGTAATCTGTCCAC
CCAGTATTTTCGTTACTGGTTTATATTAGT|AGTGCAGGCGCCAGTTTCGGAAGCTGCGAA
GTTGTGCAATAATGCCAAACAAGCTGTCTA|TTGTAGCTTGTGCAATTTGTGCAATAATGC
ATGCCAAACAAGCTGTCTAATGCAATAATG|CAATAATGCCAAACAAGCTGTCTAAAATGT
CAAGCTGTCTAATAGCCCTATACAGGTGCC|CAGCCCGACCATGCTCGTAATCTGTCCACT
AGCTGTCTAAGGAAGTCCGACTGGTAGCGT|TGTGGCTTCGGCTCCCAGCACCTCTCGTCT
ATATTAGTGGAGGTTGTAGTTGCAACTGTG|GCTGCGAACTGTTCGTCGCGGGTTTTATTG
ATACCGTTGACCTTTGTGCAATAATGCCAA|GCTGTCTAATGCAATAATGCCAAACAAGCT
TTCAGGATAATGCGAAGCAGCTCAATGGTT|GCCAAACAAGCTGTCTAAAACATTACAGAA
AATGCCAAACAAGCTGTCTTGTGCAATAAT|GCGATAACGGTAGTTCCGTTGTGCAATAAT
GAGAAGTGTGGCTTCGGCTCCCAGCACCTC|TAACGTGCCGAACACTTTGTGCAATAATGC
GAGGTCGTATAGCTGTCGCGAAACCCTAGA|TAGTGGAGGTTGTAGTTGCAACTGTGGAAA
TTGTGCAATTTGTGCAATAATGCCAAACAA|TGCCGTTGTGCAATAATGCCAAACAAGCTG
CGATAAAGAGCCTTTGCTGTCATCCGCTAG|AAGCGAGAAGTGGGATTAGTATAACAGAGT
GCAATAATGCCAAACAAGCTGTCTAAGCGT|CTAAAATGTGTTGTGCAATAATGCCAAACA
AGATGCATTTAAGTTGTGCAATAATGCCAA|TCTAATAAGCGATTGTAGCTTGTGCAATTT
CCAGCACCTCTCGTCTCGTTAACGCTGCCT|GCAATAATGCCAAACAAGCTGTCTAAACAC
AACGTGCCGAACACTTTGTGCAATAATGCC|TCGTTTGGGAGTTTATCGTTCAGGATAATG
ACCGGAAGAGAAGTGTGGCTTCGGCTCCCA|CATTGTCTAACGTGCCGAACACTTTGTGCA
CCACCAGCTATCACGGGAGATCTTACTTTT|ACTAAGGCATTCGTTTCATGTACTCGGATG
CCAAACAAGCTGTCTATTGTGCAATAATGC|ATTTGTGCAATAATGCCAAACAAGCTGTCT
ACACCAGCTTGAGCTCGTCTGAGGTCGTAT|TTTTCGTTACTGGTTTATATTAGTGGAGGT
ATTGTGCAATAATGCCAAACAAGCTGTCTA|TCGCGAAACCCTAGACGCGGCCCAACTAGC
CGAAGCAGCTCAATGGTTTACCAGTATTTT|GTCTAAAACATTACAGAACCAGTGCAGGCG
TAATGCCAAACAAGCTGTCTAACATTGTCT|CCTAGACGCGGCCCAACTAGCACCCATAAC
GACGACGGCATAATTGATCGCAGCCCGACC|CTGTCATCCGCTAGGGAAAACATAGTTGGC
TGGAAAGGTGCGCCGTTTTGAGTATACCGT|TGTTGTGCAATAATGCCAAACAAGCTGTCT
CTGTCTAACATTGTCTAACGTGCCGAACAC|AACTAGCACCCATAACTCGTTTGGGAGTTT
CGTTACTGGTTTATATTAGTGGAGGTTGTA|CCAGTTTCGGAAGCTGCGAACTGTTCGTCG
CGACCCGTAGCCTCATCTGTTTTGTGCAAT|GATGGATCTGGCGTCTACCCGCGCCAGATT
CGCTAGGGAAAACATAGTTGGCCAGGTAGA|CAGAGTCCCCAGAGAGTTGGTTTGTCGCGT
